# Menu
User = Utente
Join... = Registrati...
Login... = Accedi...
Log in = Accedi
Logout = Esci
Change password... = Cambia password...
User Preference = Preferenze dell'utente
System Settings... = Impostazioni di sistema...
System Settings = Impostazioni di sistema
Crash = Crash
Invite friends... = Invita i tuoi amici...
Language = Lingua
Language Setting = Lingua

Document Recovery = Ripristina il documento
Your Preferences Information = Informazioni sulle preferenze utente
File = File
New = Nuovo
Project... = Progetto...
Schematic = Schema
Schematic-Simulation = Simulazione dello schema
Spice Symbol = Simbolo Spice
Spice Subckt = Sottocircuito Spice
spicePre = spicePre
PCB = PCB
Schematic Module = Modulo per schema
PCB Module = Modulo per PCB
Save... = Salva...
Save As... = Salva come...
Save As Module... = Salva come modulo...
Print = Stampa
Export Document = Esporta il documento
LTspice... =  LTspice...
Eagle... = Eagle...
Altium... = Altium...
Cadence... =
Pads... = Pad...
DXF = DXF
Import = Importa

Edit = Modifica
Undo = Annulla
Redo = Ripristina
Cut = Taglia
Copy = Copia
Paste = Incolla
Select = Seleziona
Delete = Cancella
Clear All = Pulisci tutto
Move = Sposta
Drag = Trascina
Bring to Front = Porta in primo piano
Send to Back = Porta sullo sfondo
Align = Allinea
Align Left = Allinea a sinistra
Align Right = Allinea a destra
Align Top = Allinea in alto
Align Bottom = Allinea in basso
Align Horizontal Centers = Allinea centri orizzontalmente
Align Vertical Centers = Allinea centri verticalmente
Distribute Horizontally = Distribuisci orizzontalmente
Distribute Vertically = Distribuisci verticalmente
Distribute Left Edges Equidistantly = Distribuisci uniformemente lati sinistri
Distribute Top Edges Equidistantly = Distribuisci uniformemente lati superiori
Align Grid = Allinea alla griglia
Rotate = Ruota
Rotate Left = Ruota a sinistra
Rotate Right = Ruota a destra
Flip Horizontal = Capovolgi orizzontalmente
Flip Vertical = Capovolgi verticalmente
Rotate and Flip = Ruota e capovolgi
Group/Ungroup Symbol... = Raggruppa/Separa simbolo...

[menu_project]
View = Visualizza
[/menu_project]
Find = Trova
Zoom In = Zoom avanti
Zoom Out = Zoom indietro
Fit in Window = Adatta alla finestra
Refresh = Aggiorna
Snap = Aggancio
Cross Cursor = Cursore a croce
Toolbars = Barra degli strumenti
Drawing Tools = Strumenti da disegno
Wiring Tools = Strumenti di cablaggio
Power Objects = Componenti di alimentazione
PCB Tools = Strumenti per PCB
Footprint Tools = Strumenti per Footprint
Layers Tool = Strumenti per strati
Layer Manager = Gestisci strati
Enable and Show All Layers = Abilita e mostra tutti gli strati
Net Visible = Visualizza Net
Auto = Auto
Digital Objects = Componenti digitali
Tools = Strumenti
Arc Center = Centro dell'arco
Arc Type = Tipo di arco
Center Point Arc = Punto centrale dell'arco
Two-point Arc = Arco due punti

Place = Posiziona
Drawing Tools = Strumenti da disegno
Arc = Arco
Elliptical Arc = Arco ellittico
Ellipse = Ellisse
Circle = Cerchio
Pie = Torta
Line = Linea
Polyline = Polilinea
Rectangle = Rettangolo
Rectangular = Rettangolare
The rectangle does not support non-90 degree rotation. Please use Solid Region instead. = Il rettangolo non supporta una rotazione diversa da 90 gradi. Per questo puoi usare lo strumento regione solida.

Rect = Rettangolo
Round Rectangle = Rettangolo arrotondato
Polygon = Poligono
Bezier = Curva Bezier
Path = Percorso
Graphic = Grafico
Bus = Bus
Bus Entry = Bus Entry
Junction = Giunzione
Net Port = Porta Net
Voltage Probe = Sonda di tensione
Power Port = Connettore di alimentazione
Wire = Filo
Annotation = Annotazione
Track = Pista
Image = Immagine
Arrow Head = Punta della freccia
Arrowhead = Punta della freccia
Arrow = Freccia
No Connect Flag = Non connesso
Place = Posiziona
Pin = Pin
Lock Selected Objects = Blocca oggetti selezionati

Miscellaneous = Miscellanea
Find Component = Trova componente
Component = Componente
Footprint... = Footprint...
This component is deleted! = Questo componente è stato eliminato!
Convert = Converti
Convert Schematic to PCB = Converti diagramma in PCB
The component ID will be reset according to the component prefix, this operation will clear Undo histories. Please notice: = L'ID del componente verrà reimpostato in base al suo prefisso, questa operazione cancellerà le cronologie di annullamento. Nota:
Please make sure the component prefixes of the schematic and PCB are corresponding = Assicurati che i prefissi dei componenti dello schema e del PCB corrispondano
Please reset the component ID of corresponding schematic or corresponding PCB too = Ripristina anche l'ID del componente dello schema o del PCB corrispondente
Do you want to continue? = Vuoi continuare?
Reset Component ID = Reimposta ID del componente
Component ID reset successfully! = ID del componente reimpostato con successo!
Convert to PCB = Converti in PCB
Update PCB = Aggiorna PCB
Shortcut Keys Setting = Configurazione tasti di scelta rapida
Edit Symbol... = Modifica simbolo...
Highlight Net... = Evidenzia Net...
Simulate = Simula
Simulation = Simulazione
Standard Mode = Modalità standard
Simulation Mode = Modalità simulazione
Change to Standard Mode = Passa alla modalità standard
Change to Simulation Mode = Passa alla modalità simulazione
Welcome to Use LCEDA = Benvenuto in LCEDA
Welcome to Use EasyEDA = Benvenuto in EasyEDA
Enable Education Edition Features for Free >>> = Abilita gratuitamente la versione Education >>>
Quick Start = Avvio rapido
More Help = Ulteriore aiuto
Explore = Esplora
Message = Messaggio
[start]
Example = Esempi
Forum = Forum
Tutorials = Tutorial
Videos = Video
[/start]
Custom Data = Dati personalizzati
LCEDA = LCEDA

Copy Result Image = Copia immagine generata
Export Result Image = Esporta immagine generata
Simulation Result = Risultato della simulazione
Simulation Results... = Risultati della simulazione...
Simulate this Sheet = Simula questo foglio
Simulate this Project = Simula questo progetto
Non-simulation mode, please switch to the simulation mode first and then run = Non sei in modalità simulazione, prima passa alla modalità simulazione e poi eseguila
Run the Document = Esegui il documento
Run the Project... = Esegui il progetto...
Netlist for Document = Netlist per il documento
Netlist for Project = Netlist per il progetto
LTspice for This Sheet... = LTspice per questo foglio...
Spice for this Project... = Spice per questo progetto...
Protel/Altium for PCB... = Protel/Altium per PCB...
PADS for PCB... = PAD per PCB...
FreePCB for PCB... = FreePCB per PCB...
Eagle for PCB... = Eagle per PCB...
Kicad for PCB... = Kicad per PCB...
OrCAD for PCB... = OrCAD per PCB...
BOM report... = Genera BOM...
BOM for Document... = BOM per documento...
BOM for Project... = BOM per progetto...
Pin Manager... = Gestisci Pin...
Spice Model... = Modello Spice...
Layer Manager... = Gestisci strati...
Net Color... = Colore Net...
Design Rule... = Regole di progettazione...
Copper Area = Zona di rame
Rebuild Selected = Rigenera selezionati
Rebuild All = Ricostruisci tutto
Copper Area Manager... = Gestisci zone di rame...
Export Pick and Place File = Esporta file Pick and Place
Measure Distance = Misura distanza
Set Canvas Origin by Mouse Location = Imposta l'origine canvas dalla posizione del mouse
Generates Pick and Place File = Genera file Pick and Place
Unroute All = Disfa tutto lo sbroglio
Auto Route = Sbroglio automatico
Export Autorouter File(DSN) = Esporta file Autorouter(DSN)
Import Autorouter Session File(SES) = Importa file di sessione Autorouter(SES)
Autorouter File(DSN) = File Autorouter(DSN)
Autorouter Session File(SES) = File di sessione Autorouter(SES)
Terminate Routing Automatically = Termina sbroglio automaticamente
Delete Segments = Cancella segmenti
Unroute Connections = Disfa sbroglio
Unroute Connection = Disfa sbroglio
Unroute Nets = Disfa Net
Select = Seleziona
Segments = Segmenti
Connection = Connessione
Net = Net
Apply Design Rule While Routing and Auto Placing Via = Applica le regole del design durante lo sbroglio e il posizionamento vie automatico

Add SubPart = Aggiungi sotto-parte
Annotate... = Annota...
Config = Configura

Help = Aiuto
About = Informazioni
Shortcut Keys = Tasti di scelta rapida
FAQ = FAQ
Tutorials = Tutorial
Basic Tutorials = Tutorial base
Video Tutorials = Video tutorial
Essential Check = Controlli essenziali
Simulation Tutorials = Tutorial di simulazione
Updated Instructions = Istruzioni aggiornate
Open File Format = Apri formato file
About Upgrade = Informazioni sull'aggiornamento
User Forum = Forum di supporto
Feature Request = Richiesta funzionalità
Feature Requests = Richieste funzionalità
Bug Report = Segnala bug
Bug Reports = Segnala bug
Tips & Skill = Suggerimenti e trucchi
Ask for Help = Chiedi aiuto
Schematic Capture = Acquisizione dello schema
Spice Simulation = Simulazione di Spice
Non-simulation mode = Modalità di non simulazione
PCB Layout = Layout del PCB
General Discussion = Discussioni generali
More Information = Maggiori informazioni
Privacy Policy = Informativa sulla privacy
#Terms of Use & Privacy Policy
Terms of Service = Termini di servizio
Plans and Pricing = Piani e prezzi
Help Translate = Aiuta nella traduzione
About Us = Chi siamo
Contact Us = Contattaci
Change History = Cronologia modifiche
Join Us = Iscriviti
#PCB Fabrication Capabilities
PCB Fabrication = Fabbricazione PCB
Order Capabilities = Opzioni dell'ordine
Order Price = Prezzo dell'ordine
Order Essential Check = Verifica dell'ordine
Order FAQ = FAQ dell'ordine
Order Process = Processo dell'ordine
Full Screen = Schermo intero

Support = Supporto
[leftNavTabs]
Support = Supporto
[/leftNavTabs]
Historical Records... = Salvataggi precedenti...
Extensions = Estensioni
Order PCB... = Ordina PCB...
Import Changes = Importa le modifiche
Press {0}F11{1} to switch to full screen. = Premi {0}F11{1} per passare a schermo intero.
Delete Selected = Cancella selezionati
Simulate... = Simula...
Config = Configura
Terms of Service & Privacy Policy = Termini di servizio & privacy
Help Topics = Aiuti
3D Model(obj) = Modello 3D(obj)
3D Model(step) = Modello 3D(step)
SVG Source... = Sorgente SVG...
File Source = File sorgente
Group These Items as a Symbol = Raggruppa elementi come simbolo
Group These Items as a Footprint = Raggruppa elementi come Footprint
Set Canvas Origin = Imposta origine canvas
Document Setting = Impostazione del documento
Sheet Properties = Proprietà del foglio
Set Board Outline = Imposta contorno della scheda
Teardrop... = Teardrop...
Panelize... = Pannellizza...
Check Dimension = Controlla dimensioni
Smart Dimension = Dimensioni intelligenti
Footprint Wizard = Procedura guidata per Footprint
Footprint Wizard... = Procedura guidata per Footprint...
Select package type = Seleziona il tipo di contenitore
Smart Dimension Properties = Proprietà dimensioni intelligenti
Global Delete = Eliminazione globale
Cross Probe = Cross probe
Cross Probe and Place = Cross Probe and Place
Paper Size = Dimensione del foglio
Register = Registrati
User Center = Account

By Mouse Location = Per posizione del mouse
Set Coordinate = Imposta coordinate
By Coordinates... = Per coordinate...
By Center of Pads = Per centro dei pad
By Center Grid of Symbols = Per centro della griglia dei simboli

#Schematic Canvas Properties
Properties = Proprietà
Apply = Applica
Save as default = Salva come predefinito
Canvas Properties = Attributi documento
Width = Larghezza
Height = Altezza
Background = Sfondo
Visible Grid = Griglia visibile
Grid Visible = Griglia visibile
Real-Time Track Length = Lunghezza della pista in tempo reale
Display Real-Time Track Length = Mostra la lunghezza della pista in tempo reale
Grid Color = Colore della griglia
Grid Size = Dimensione della griglia
Grid Style = Stile della griglia
Grid.Line Width = Larghezza della linea
Grid.Line Spacing = Spaziatura tra le linee
Copper to Board Outline = Da zona di rame a contorno scheda
Improve Fabrication = Migliora la fabbricabilità
Spoke Width = Larghezza della punta
Stroke Color = Colore del tratto
Stroke Width = Spessore del tratto
Stroke Style = Stile del tratto
Fill Color = Colore di riempimento
Selected Objects = Oggetti selezionati
Frame Size = Dimensione della cornice
Alt Snap = Spaziatura aggancio secondario
Snap size when pressing the Alt key = Spaziatura aggancio secondario (quando premi il tasto Alt)
Prefix Start = Inizio del prefisso

#Text Properties
Text Properties = Proprietà del testo
Text = Testo
Color = Colore
Font Family = Famiglia del carattere
Font Size = Dimensione del carattere
Font Weight = Spessore del carattere
Font Style = Stile del carattere
Text Type = Tipo di testo
Text Anchor = Allineamento del testo
Baseline = Linea di base
(Auto) = (Auto)
(auto) = (auto)
start = inizio
middle = centrale
end = fine
inherit = eredita
comment = commento
spice = spice
normal = normale
italic = corsivo
Default = Predefinito
Add = Aggiungi
bold = spesso
bolder = più spesso
lighter = più sottile
Failed to parse the font file: {name} = Errore durante il parsing del carattere: {name}
Please select a font file of ttf or woff format. = Seleziona un carattere in formato ttf o woff.
Add font success: {name} = Carattere aggiunto con successo: {name}
Failed to add font: {name} = Impossibile aggiungere il carattere: {name}
Add Font = Aggiungi un carattere
Failed to parse cached font: {name} = Impossibile elaborare il carattere presente nella cache: {name}
Load cached fonts fail! = Impossibile caricare i caratteri della cache!

#Stroke
Stroke Color = Colore del tratto
Stroke Width = Spessore del tratto
Stroke Style = Stile del tratto
Fill Color = Colore di riempimento
X Radius = Raggio X
Y Radius = Raggio Y

#spice
Switch mode = Cambia modalità
The current documents will be closed, and reopen after switching mode, do you want to continue? = Il documento corrente verrà chiuso e sarà riaperto dopo aver cambiato modalità. Vuoi continuare?
PCB related documents are not allowed in emulation mode = I documenti dei PCB non sono consentiti in modalità emulazione
Please change the editor to "Simulation" mode first at the top left corner. = Prima devi passare alla modalità "Simulazione", cliccando nell'angolo in alto a sinistra.
Please change the editor to "Standard" mode first at the top left corner. = Prima devi passare alla modalità "Standard", cliccando nell'angolo in alto a sinistra.
Common = Comune
spice.open = apri spice
spice.close = chiudi spice
Sources = Sorgenti
Instruments/Meters = Strumenti/Metri
Transistors = Transistor
Digital Circuits = Circuiti digitali
Operational Amplifier = Amplificatore operazionale
multimeter = multimetro
multimeter Settings = Impostazioni multimetro
FunctionGenerator Settings = Impostazioni generatore di funzioni
Voltage Source Settings = Impostazioni generatore di tensione
Current Source Settings = Impostazioni generatore di corrente
Powersw Settings = Impostazioni powersw
Resistor Settings = Impostazioni del resistore
Capacitor Settings = Impostazioni del condensatore
Diode Settings = Impostazioni del diodo
voltPowersw Settings = Impostazioni voltPowersw
Inductor Settings = Impostazioni dell'induttore
VCVS Settings = Impostazioni VCVS
CCCS Settings = Impostazioni CCCS
VCCS Settings = Impostazioni VCCS
CCVS Settings = Impostazioni CCVS
JFET Settings = Impostazioni JFET
FET Settings = Impostazioni FET
Transmission Line Settings = Impostazioni della linea di trasmissione
Oscilloscope Settings = Impostazioni dell'oscilloscopio
XFMR Settings = Impostazioni XFMR
LOGIC Settings = Impostazioni LOGIC
LOGICSTATE Settings = Impostazioni LOGICSTATE
DIGITALCLOCK Settings = Impostazioni Clock Digital
Potentiometer Settings = Impostazioni potenziometro
MUTUAL_INDUCTORS Settings = Impostazioni INDUTTORI_RECIPROCI
NE555 Settings = Impostazioni NE555
THREE_PHASE Settings = Impostazioni trifase
Logic_Probe Settings = Impostazioni della sonda logica
78XX Settings = Impostazioni 78XX
79XX Settings = Impostazioni 79XX
OPAMP5PEE Settings = Impostazioni OPAMP5PEE
OPAMP5PEECN Settings = Impostazioni OPAMP5PEECN
OPAMP3PEE Settings = Impostazioni OPAMP3PEE
OPAMP3PEECN Settings = Impostazioni OPAMP3PEECN
DELAY_FUSE Settings = Impostazioni del fusibile ritardato
Ratio = Rapporto
K[%] = K[%]
Model = Modello
States = Stati
Voltage[V] = Tensione[V]
Voltage gain[V/V] = Guadagno tensione[V/V]
Current gain[A/A] = Guadagno corrente[A/A]
Transconductance[Mho] = Transconduttanza[Mho]
Transresistance[Ω] = Transresistenza[Ω]
Voltage Source Type = Tipo generatore di tensione
Current Source Type = Tipo generatore di corrente
multimeter type = tipo di multimetro
power type = tipo di alimentazione
Voltmeter Resistance(R)(Ω) = Resistenza voltmetro(R)(Ω)
Amperometer Resistance(R)(Ω) = Resistenza amperometro(R)(Ω)
mu.V = mu.V
mu.A = mu.A
Sine Wave = Onda sinusoidale
Triangular Wave = Onda triangolare
Rectangular Wave = Onda rettangolare
AC = AC
DC = DC
SINE = SENO
PULSE = IMPULSO
EXP = EXP
SFFM = SFFM
PWL = PWL
B.spice = B.spice
DC Value[V] = Valore DC[V]
DC Value[A] = Valore DC[A]
DC offset[V] = DC offset[V]
DC offset[A] = DC offset[A]
Amplitude[V] = Ampiezza[V]
Amplitude[A] = Ampiezza[A]
Freq[Hz] = Frequenza[Hz]
Theta[1/s] = Theta[1/s]
Tdelay[s] = Tdelay[s]
Phi[deg] = Phi[deg]
Tperiod[s] = Tperiod[s]
Ton[s] = Ton[s]
Tfall[s] = Tfall[s]
Trise[s] = Trise[s]
Von[V] = Von[V]
Von[A] = Von[A]
Vinitial[V] = Vinitial[V]
Vinitial[A] = Vinitial[A]
Vpulsed[V] = Vpulsed[V]
Vpulsed[A] = Vpulsed[A]
Rise Delay[s] = Ritardo della salita[s]
Rise Tau[s] = Tau della salita[s]
Fall Delay[s] = Ritardo della caduta[s]
Fall Tau[s] = Tau della caduta[s]
Carrier Freq[Hz] = Frequenza portante[Hz]
Modulation Index = Indice di modulazione
Signal Freq[Hz] = Frequenza del segnale[Hz]
Time[s] = Tempo[s]
Value[V] = Valore[V]
Value[A] = Valore[A]
Waveforms = Forme d'onda
Duty cycle[%] = Duty cycle[%]
Amplitude[Vp] = Ampiezza[Vp]
Offset[V] = Offset[V]
Rise/Fall Time[sec] = Tempo di salita/discesa[sec]
Capacitance[F] = Capacità[F]
sComponent = sComponent
Inductance[H] = Induttanza[H]
Gbw = Gbw
Slewrate = Velocità di risposta
Avol = Avol
Rout(Ω) = Rout(Ω)
Rin(Ω) = Rin(Ω)
Ibias[A] = Ibias[A]
Inhi[V] = Inhi[V]
Inlo[V] = Inlo[V]
Isc[A] = Isc[A]
Outhi[V] = Outhi[V]
Outlo[V] = Outlo[V]
Vabsmax[V] = Vabsmax[V]
Vmin[V] = Vmin[V]
Iq[A] = Iq[A]
Cin[F] = Cin[F]
high = alto
low = basso
Oscilloscope = Oscilloscopio
Logic Analyzer = Analizzatore logico
Channel_A = Canale_A
Channel_B = Canale_B
Channel A = Canale A
Channel B = Canale B
Time = Tempo
Reverse = Inverti
Simulation file exceed = Il file di simulazione è troppo grande
The simulation file is too large and has been stopped for performance reasons. = Il file di simulazione é troppo grande ed è stato fermato per ragioni di performance.
Timebase = Tempo base
Scale: = Scala:
X pos.(Div): = pos. X(Div):
Y pos.(Div): = pos. Y(Div):
View meter... = Vedi misuratore...
The circuit has components without simulation model: = Il circuito ha componenti senza il modello di simulazione:
Your simulation interval is too short to simulate, please wait 5 seconds later and try again; if still show this message, may be you simulated over 500 times the maximum simulation times per day. = L'intervallo di simulazione è troppo breve, attendi 5 secondi e riprova; se ancora vedi questo messaggio, potresti aver superato il limite giornaliero di simulazioni.
Resistor1_US = Resistenza1_US
Resistor1_EU/IEC = Resistenza1_EU/IEC
Resistor1_3D = Resistenza1_3D
Capacitor1_US = Condensatore1_US
Capacitor1_EU/IEC = Condensatore1_EU/IEC
Capacitor1_3D = Condensatore1_3D
Rheostat_US = Reostato_US
Rheostat_EU/IEC = Reostato_EU/IEC
Rheostat_3D = Reostato_3D
Capacitor_Electrolytic_US = Condensatore_Elettrolitico_US
Capacitor_Electrolytic_EU/IEC = Condensatore_Elettrolitico_EU/IEC
Capacitor_Electrolytic_3D = Condensatore_Elettrolitico_3D
Inductor_US = Induttore_US
Inductor_EU/IEC = Induttore_EU/IEC
Inductor_3D = Induttore_3D
Resistor2_US = Resistenza2_US
Resistor2_EU/IEC = Resistenza2_EU/IEC
Resistor2_3D = Resistenza2_3D
Multimeter = Multimetro
Multimeter_3D = Multimetro_3D
Oscilloscope = Oscilloscopio
Oscilloscope_3D = Oscilloscopio_3D
Signal_Generator = Generatore_Segnale
Signal Generator_3D = Generatore_Segnale_3D
Wattmeter = Wattmetro
Wattmeter_3D = Wattmetro_3D
NSSWS1080T_3D = NSSWS1080T_3D
Voltage_Source_VDC = Generatore_Tensione_VDC
Voltage_Source_VSin = Generatore_Tensione_VSin
Voltage_Source_VPULSE = Generatore_Tensione_VPULSE
Voltage_Source_VEXP = Generatore_Tensione_VEXP
Voltage_Source_VSFFM = Generatore_Tensione_VSFFM
Voltage_Source_VPWL = Generatore_Tensione_VPWL
Voltage_Source_V_Behavioral_Source = Generatore_tensione_V_comportamentale
Current_Source_IDC = Generatore_Corrente_ IDC
Current_Source_ISin = Generatore_Corrente_ISin
Current_Source_IPULSE = Generatore_Corrente_IPULSE
Current_Source_IEXP = Generatore_Corrente_IEXP
Current_Source_ISFFM = Generatore_Corrente_ISFFM
Current_Source_IPWL = Generatore_Corrente_IPWL
Current_Source_I_Behavioral_Source = Generatore_corrente_I_comportamentale
CCCS_1 = CCCS_1
CCCS_2 = CCCS_2
CCVS_1 = CCVS_1
CCVS_2 = CCVS_2
VCCS = VCCS
VCVS = VCVS
Three_Phase_Wye_Load = Carico stella trifase
Three_Phase_Delta_Load = Carico delta trifase
78XX = 78XX
79XX = 79XX
555 = 555
555_3D = 555_3D
Transformer_US = Trasformatore_US
Transformer_EU/IEC = Trasformatore_EU/IEC
Transformer_Center_Tapped_US = Trasformatore_a_presa_centrale_US
Transformer_Center_Tapped_EU/IEC = Trasformatore_a_presa_centrale_EU/IEC
Mutual_Inductor_US = Induttore_reciproco_US
Mutual_Inductor_EU/IEC = Induttore_reciproco_EU/IEC
Mutual_Inductor2_US = Induttore_reciproco2_US
Mutual_Inductor2_EU/IEC = Induttore_reciproco2_EU/IEC
OR2EE_US = OR2EE_US
OR3EE_US = OR3EE_US
OR4EE_US = OR4EE_US
OR2EE_CN = OR2EE_CN
OR3EE_CN = OR3EE_CN
OR4EE_CN = OR4EE_CN
NOR2EE_US = NOR2EE_US
NOR3EE_US = NOR3EE_US
NOR4EE_US = NOR4EE_US
NOR2EE_CN = NOR2EE_CN
NOR3EE_CN = NOR3EE_CN
NOR4EE_CN = NOR4EE_CN
AND2EE_US = AND2EE_US
AND3EE_US = AND3EE_US
AND4EE_US = AND4EE_US
AND2EE_CN = AND2EE_CN
AND3EE_CN = AND3EE_CN
AND4EE_CN = AND4EE_CN
NAND2EE_US = NAND2EE_US
NAND3EE_US = NAND3EE_US
NAND4EE_US = NAND4EE_US
NAND2EE_CN = NAND2EE_CN
NAND3EE_CN = NAND3EE_CN
NAND4EE_CN = NAND4EE_CN
XOR2EE_US = XOR2EE_US
XOR2EE_CN = XOR2EE_CN
XNOR2EE_US = XNOR2EE_US
XNOR2EE_CN = XNOR2EE_CN
Digital_Clock_1Hz = Clock_digitale_1Hz
Logicstate_0 = Stato logico 0
Logicstate_1 = Stato logico 1
Logic_Probe = Sonda_logica
Buffee = Buffer
INVEE_US = INVEE_US
INVEE_CN = INVEE_CN
Schmittbuffee = Buffer di Schmitt
LM358N_US = LM358N_US
LM358N_CN = LM358N_CN
OPAMP3PEE_US = OPAMP3PEE_US
OPAMP3PEE_CN = OPAMP3PEE_CN
OPAMP5PEE_US = OPAMP5PEE_US
OPAMP5PEE_CN = OPAMP5PEE_CN
Voltage_Controlled_Switch = Interruttore_controllato_in_tensione
Current_Controlled_Switch = Interruttore_controllato_in_corrente
FUSE = FUSIBILE
Delay_Fuse = Fusibile ritardato
Transmission_Line = Linea di trasmissione
Crystal = Cristallo
DFFEE = DFFEE
TFFEE = TFFEE
JKFFEE = JKFFEE
SRFFEE = SRFFEE
SRLATCHEE = SRLATCHEE
SRNANDFFEE = SRNANDFFEE
SRNORFFEE = SRNORFFEE
INVTSEE = INVTSEE
INVODEE = INVODEE
Schmittbuffee = Buffer di Schmitt
Cbuffer = Cbuffer
SPDT_Open = Apri_SPDT
SPDT_Close = Chiudi_SPDT
SPST_Close = Chiudi_SPST
SPST_Open = Apri_SPST
Fast_Crystal = Cristallo veloce
Lamp = Lampadina
BCD_Segment = Segmento_BCD
Seven_Segment = Sette_segmenti
Traffic_Light = Semaforo
Lamp Settings = Impostazioni della lampadina
Power[W] = Potenza[W]
Dropout Voltage[V] = Caduta di tensione[V]
Current[A] = Corrente[A]
Threshold[V] = Soglia[V]
Clock Rate = Frequenza di clock
TrafficLight Settings = Impostazioni del semaforo
BCDSegment Settings = Impostazioni dei segmenti BCD
SevenSegment Settings = Impostazioni dei sette segmenti
SPDT Settings = Impostazioni del SPDT
SPST Settings = Impostazioni del SPST
LogicAnalyzer Settings = Impostazioni dell'analizzatore logico
Fuse Settings = Impostazioni del fusibile
Wattmeter Settings = Impostazioni del misuratore di potenza
open = apri
close = chiudi
Common Anode = Anodo comune
Common Cathode = Catodo comune
AC Amplitude = Ampiezza AC
AC Phase = Fase AC
There are some parts haven't spice model, please use "EElib" and "Spice Symbol" at "Libraries" of "Simulation" mode, or you can assign the spice model for them: = Alcuni componenti non sono associati al modello spice, usa "EELib" e "Simbolo Spice" in "Librerie" in modalità simulazione oppure assegnali ad un modello spice:

#Pin
Pin Properties = Proprietà Pin
Orientation = Orientamento
Line 45° = Linea 45°
Line 90° = Linea 90°
Arc 45° = Arco 45°
Arc 90° = Arco 90°
Free Angle = Angolo libero
Start X = Inizio X
Start Y = Inizio Y
Length = Lunghezza
Name = Nome
name = nome
Number = Numero
Spice Pin Order = Ordine pin Spice
Display Number = Mostra numero
Clock = Clock
Show = Mostra
Electric = Elettrico

#Junction
Junction Properties = Proprietà della giunzione
X Location = Posizione X
Y Location = Posizione Y
Size = Dimensione
Color = Colore

#Net Label
Net Label = Etichetta net

#Part
Prefix = Prefisso

#Image Properties and Dialog
Add Image = Aggiungi immagine
Image Properties = Proprietà immagine
Image URL = URL dell'immagine
Input an image URL = Inserisci un indirizzo URL dell'immagine
Invalid image URL = Indirizzo URL dell'immagine non valido
Invalid Prefix = Prefisso non valido
Failed to load the image = Problema nel caricamento dell'immagine
Image URL contains special characters = L'indirizzo URL dell'immagine contiene caratteri speciali
From Web URL = Da indirizzo web
From Local Computer = Da computer locale
Please select a png/gif/jpg file. = Seleziona un file png/gif/jpg.
Please select an image file. = Seleziona un file immagine.
Select an image file = Seleziona un file immagine
Insert Image to PCB = Inserisci immagine sul PCB
Tolerance = Tolleranza
tolerance = tolleranza
capacitance = capacità
frequency = frequenza
Rated Voltage = Tensione nominale
Rated Current = Corrente nominale
resistance = resistenza
Resistance = Resistenza
Resistance[Ω] = Resistenza[Ω]
inductance = induttanza
Operating Temperature = Temperatura operativa
Shape Invert = Inverti forma
Image Size = Dimensione dell'immagine
Color Tolerance = Tolleranza del colore
Simplify Level = Livello di semplificazione
Corner Threshold = Soglia dell'angolo

#PCB Canvas Properties
Units = Unità
Snap Size = Spaziatura aggancio
Other = Altro
Routing Width = Larghezza della pista
[router]
Routing Width = Larghezza della pista
[/router]
Please using hotkey {0}{shiftw}{1} or {2}{tab}{3} to change track width while on routing. = Usa la combinazione {0}{shiftw}{1} o {2}{tab}{3} per cambiare la larghezza della pista durante lo sbroglio.
Routing Angle = Angolo dello sbroglio
Routing Conflict = Conflitto dello sbroglio
Remove Loop = Rimuovi il loop
Cut SilkScreen = Taglia la serigrafia
Grid = Griglia
Grid 90 = Griglia 90
Grid 45 = Griglia 45
Copper Zone = Zona di rame
Visible = Visibile
Invisible = Invisibile
Ignore = Ignora
Block = Blocca
RoundTrack = Aggira

#Track
Track Properties = Proprietà della pista
Layer = Strato
Net = Net
Start X = Inizio X
Start Y = Inizio Y
End X = Fine X
End Y = Fine Y
ID = ID

#Pad Properties
Pad Properties = Proprietà Pad
Shape = Forma
Hole(D) = Foro(D)
Center X = Centro X
Center Y = Centro Y
Round = Rotondo
Oval = Ovale
Hole Shape = Forma del foro
Slot = Slot
Hole(Length) = Foro(Larghezza)
Plated = Metallizzato
None = Nessuno
Paste Mask Expansion = Espansione Paste Mask
Solder Mask Expansion = Espansione Solder Mask

#Via Properties
Via Properties = Proprietà via
Diameter = Diametro
Drill Diameter = Diametro del foro

#Hole Properties
Hole Properties = Proprietà del foro


#TEXT
Text Properties = Proprietà del testo
Line Width = Larghezza della linea
Rotation = Rotazione
Fonts Management = Gestisci caratteri

#Dimension Properties
Dimension Properties = Proprietà dimensioni

#Footprint Properties
Component Properties = Proprietà del componente
Display Prefix = Mostra prefisso
Pin Name = Nome pin
Pin Number = Numero pin
Spice Pin Number = Numero pin spice
Graphics = Grafica
Pattern = Modello

#Arc Properties
Arc Properties = Proprietà dell'arco
Start Angle = Inizio dell'angolo
End Angle = Fine dell'angolo
Rotation Direction = Direzione della rotazione

#Rect Properties
Rect Properties = Proprietà del rettangolo
Round radius = Raggio del raccordo

#Circle Properties
Circle Properties = Proprietà del cerchio
Radius = Raggio

#CopperArea Properties
CopperArea Properties = Proprietà delle aree di rame
Clearance = Isolamento
Pad Connection = Connessione Pad
Direct = Diretto
Spoke = Raggi
Keep Island = Mantieni le isolette
Fill Style = Stile di riempimento
CopperArea conflict: copper area outlines in same layer with different net names must not overlap = Conflitto zona di rame: le sagome di rame nello stesso strato ma con diverse reti non possono sovrapporsi
Copper area rebuild complete! You can set "Copper Zone" as "Visible" at the right-hand property panel after single click the empty area. = Zone di rame rigenerata! Puoi impostare la zona di rame come "visibile" nelle proprietà del menu destro dopo aver cliccato su una area vuota.
Please create board outline first. = Prima deve essere creato il contorno della scheda.
Board outlines are not closed. = Il contorno della scheda non é chiuso.
Rebuild CopperArea = Rigenera zona di rame
Edit Points = Modifica i punti
Direct = Diretto
Spoke = Raggi
No Solid = Non solido
Board Cutout = Ritaglio della scheda
Solid = Solido
[copperArea]
None = Nessuno
[/copperArea]

#Custom Properties
Custom Properties = Proprietà personalizzate
Fixed Properties = Proprietà fisse
Add new parameter = Aggiungi un nuovo parametro
Add New Parameter = Aggiungi un nuovo parametro
Add New Supplier = Aggiungi un nuovo fornitore
Mounted = Montato
Unknown = Sconosciuto

Custom = Personalizzato
Scan the QR code below and open it on the mobile side = Inquadra il codice QR sottostante per vederne il contenuto
How to create a single layer PCB = Come creare un PCB a strato singolo
Currently doesn't support layout single layer directly, please refer at: = Al momento un layout con un singolo strato non é supportato direttamente, fai riferimento a:

#Dialog Register
Create an account = Crea un account
Username = Nome utente
Password = Password
Confirm Password = Conferma password
Email = Email
Please read this before you register = Leggi questo prima di effettuare la registrazione
Hi {username} = Ciao {username}

#Dialog lostPassword
Lost Password... = Password dimenticata...
Find the password using your email = Ripristina la password utilizzando la tua email



#Dialog Login
Login = Accedi
Username or Email = Nome utente o email
Remember Me = Ricordami
Third party = Terze parti
Login and Register = Accedi e registrati
Your login information seems expired, please login again. Don't need to close the opening files, you can continue to save them after login. = Le informazioni di accesso sembrano scadute, esegui nuovamente l'accesso. Non hai bisogno di chiudere i file aperti, puoi continuare a salvarli dopo l'accesso.

#Dialog Reset Password
Reset a password using your email = Reimposta la password utilizzando la tua email
Your registered email = La tua email di registrazione

#Dialog Reaction
Re-send an activation code to your email = Invia di nuovo il codice di attivazione alla tua email

#Dialog Invite
Invite friends to register = Invita gli amici a registrarsi
Your friend's email = L'email del tuo amico

#Dialog Add A New Parameter
Add a new parameter = Aggiungi un nuovo parametro
Key = Chiave
Value.new_para = Valore.new_para
In BOM = Nel BOM
Add into BOM = Aggiungi al BOM
Invalid key = Chiave non valida
This field is required. = Questo campo é obbligatorio.

#Dialog Change Your Password
Change your password = Cambia la tua password
Old password = Vecchia password
New Password = Nuova password
Confirm Password = Conferma password

#Dialog Create New Design
Save as a New Project = Salva come nuovo progetto
Save as a schematic = Salva come schema
Save as Symbol = Salva come simbolo
Save as a spice Symbol = Salva come simbolo Spice
Save as a spice subckt = Salva come sottocircuito Spice
YOU MUST CREATE A SPICE SYMBOL WITH EXACTLY THE SAME NAME AS THIS SUBCKT = DEVI CREARE UN SIMBOLO SPICE CON LO STESSO IDENTICO NOME COME QUESTO SOTTOCIRCUITO
Save as a PCB file = Salva come file PCB
Save as Footprint = Salva come Footprint
Save as a Schematic Module = Salva come modulo schematico
Save as a PCB Module = Salva come modulo PCB
Save as 3D Model = Salva come modello 3D
Save as a WaveForm = Salva come forma d'onda
Title = Titolo
Share = Condividi
Add file = Aggiungi file
Visibility = Visibilità
Allow Comments = Consenti i commenti
Public (Anyone can see this project but only you can modify it.) = Pubblico (Tutti potranno vedere questo progetto, ma solo tu potrai modificarlo.)
Private (Only you can see and modify this project) = Privato (Solo tu potrai vedere e modificare questo progetto)
Create new project success! = Nuovo progetto creato con successo!
You can now create files under this project = Ora puoi creare file all'interno di questo progetto
This file must be saved under a project, choose other project or create a new project = Il file deve essere salvato in un progetto, selezionane uno o crea un nuovo progetto
Please login to save this kind of document = Accedi per salvare questo tipo di documento
Duplicated project title = Il titolo del progetto è già presente
#Duplicated document title
Project does not exist = Il progetto non esiste
Document does not exist = Il documento non esiste
document not exists = il documento non esiste

Categories = Categorie
Project = Progetto
Short description = Breve descrizione
Content = Contenuto
Modify this project info. = Modifica le informazioni di questo progetto.
Modify this file info. = Modifica le informazioni di questo file.
Notice = Avviso
Search for it before creating a new one. = Cercalo prima di crearne uno.
Manufacturer Part Number = Codice componente del produttore
Supplier = Fornitore
Or = O
Supplier Part = Codice componente del fornitore
Supplier Part Number = Codice componente del fornitore
Link = Link
link = link
The professional function please refer at: = Per la funzione professionale fai riferimento a:

#Dialog Clone My Part
#Clone it to a project
#Clone it, then edit it
Clone your file = Duplica il tuo file

#Dialog Subckt
Attach a Subckt to this spice symbol = Collega un sottocircuito a questo simbolo spice
Subckt string = Stringa sottocircuito
Spice symbol title just allow [0-9][a-z][A-Z] and _ = Il titolo del simbolo spice accetta solo [0-9][a-z][A-Z] e _

#Design Manager
Design Manager = Gestisci design
Nets = Net
DRC Errors = Errori DRC
Are you sure you want to unroute this net? = Sei sicuro di voler disfare lo sbroglio di questa net?
Unroute = Disfa sbroglio
Track Length = Lunghezza della pista
Via/Hole Outer Size = Dimensione esterna via/foro
Filter nets = Filtro net
Design Rule Checking = Controllo delle regole di progettazione
Board Outline = Contorno della scheda
Plane Zone = Zona del piano
[drcRule]
Width = Larghezza
DRC Width = Larghezza DRC
Length = Lunghezza
DRC Length = Lunghezza DRC
Drill Diameter = Diametro del foro
DRC Drill Diameter = Diametro del foro DRC
Diameter = Diametro
DRC Diameter = Diametro DRC
Object = Componente
DRC Clearance = Isolamento DRC
[/drcRule]
#It will take a while to unroute this net, do you want to continue?
More than one netlabel is found in wire, please checked whether this is correct, if you design it on purpose, please ignore this warning. = Nel filo è stata trovata più di una netlabel, controlla se è corretto, se lo progetti di proposito, ignora questo avviso.
Incomplete net, a complete net should contain two or more pins, if you design it on purpose, please ignore this warning. = Net incompleta, una rete completa dovrebbe contenere due o più pin, se la progetti di proposito, ignora questo avviso.
This netlabel is not connected with any pin. = La netlabel non è connessa ad alcun pin.
Incomplete connection, please check. = Connessione incompleta, controlla.
The clearance between two objects is less than the Design Rule Checking (DRC) clearance which has different nets. = La distanza tra due oggetti è inferiore a quella del Design Rule Checking (DRC) che ha net differenti.
The diameter is less than Design Rule Checking (DRC) diameter = Il diametro è più piccolo di quello del DRC
The drill diameter is less than Design Rule Checking (DRC) drill diameter = Il diametro del foro è più piccolo di quello del DRC
The track length is longer than Design Rule Checking (DRC) track length = La lunghezza della pista è più lunga di quella del DRC
The track width is less than Design Rule Checking (DRC) track width = La larghezza della pista è più piccola di quella del DRC

#Dialog Simulation
Show your simulation report = Mostra rapporto della simulazione
Download netlist = Scarica netlist
Run = Avvia
Components = Componenti

#Dialog Import
Import file from your computer = Importa file dal tuo computer
Maximum file size: 30 MB = Dimensione massima del file: 30 MB
Maximum file size: 100 MB = Dimensione massima del file: 100 MB
Chose file = Scegli file
File Operation = Operazione del file
Import File = Importa file
Extract Libs = Estrai librerie
Import File and Extract Libs = Importa file ed estrai le librerie
File type = Tipo di file
The file size is too large. = La dimensione del file è troppo grande.
Please selected the file type. = Seleziona il tipo di file.
No component was found! = Nessun componente trovato!
Import successfully = Importato con successo
Import failed = Impossibile importare
Click OK to continue with the import = Clicca su OK per continuare con l'importazione
Select None = Non selezionare niente

#Dialog Modify Symbol Information
Modify symbol information = Modifica informazione del simbolo
Spice Prefix = Prefisso Spice
Hide Pin = Nascondi Pin
Pin Manager = Gestisci Pin
When a power pin is hidden, it will be marked as netlabel, you don't need to wire it. If you use it as simulation, please show it or create a GND/VCC Net for it. = Quando un Pin di alimentazione è nascosto, viene marcato come Netlabel e non c'è bisogno di collegarlo. Se usato in una simulazione, mostralo o crea una rete GND/VCC per il pin.
Assign = Assegna
Supplier.bom = Fornitore.bom
LCSC.bom = LCSC.bom
Price = Prezzo
Quantity.bom = Quantità.bom
Package.bom = Contenitore.bom
Components.bom = Componenti.bom
Manufacturer Part.bom = Codice componente del produttore.bom
Manufacturer.bom = Produttore.bom

One-click Purchasing at LCSC = Acquista con un click su LCSC
Order Parts = Ordina componenti/Controlla disponibilità
Export BOM = Esporta BOM
Export PCB BOM = Esporta BOM PCB
Export Schematic BOM = Esporta schema BOM
ID.bom = ID.bom
Name.bom = Nome.bom
[bom]
Name = Nome
LCSC Assembly = Assemblaggio LCSC
Value = Valore
ID = ID
Supplier = Fornitore
LCSC = LCSC
Price = Prezzo
Quantity = Quantità
Package = Contenitore
Components = Componenti
Manufacturer = Produttore
[/bom]
Manufacturer Part = Codice componente del produttore

#Dialog Run
Run your simulation = Avvia la tua simulazione
Transient = Transitorio
Maximum Timestep = Tempo massimo
Stop Time = Orario di arresto
Start Time = Orario di partenza

AC Analysis = Analisi AC
Type of Sweep =
Number of points = Numero di punti
Start Frequency = Frequenza di partenza
Stop Frequency =  Frequenza di arresto

DC sweep =
Source to Sweep =
Start Value = Valore di partenza
Stop Value = Valore di arresto
Increment = Incremento
DC Transfer = Trasferimento DC
Output = Uscita
Source = Sorgente

DC op pnt = DC op pnt
Compute the DC operating point treating capacitances as opens and inductances as shorts = Calcola il punto operativo della DC, trattando le capacità come circuiti aperti e le induttanze come cortocircuiti

#Dialog Share Info
Active File = File attivo
Active Project = Progetto attivo
Readonly = Sola lettura
Editable = Modificabile
Active file's owner project page = Pagina del progetto del proprietario del file attivo
Active project editor page = Pagina dell'editor del progetto attivo

#Dialog Document Recovery
All Projects = Tutti i progetti
Document Recovery = Recupero documenti
Unsaved files = File non salvati
Please select a file! = Seleziona un file!
Please expand the folder first, then select a document to recover. = Espandi dapprima la cartella, poi scegli il documento da ripristinare.
Are you sure you want to remove this backup? = Sei sicuro di voler eliminare questo backup?

#Dialog Find Libs
Search = Cerca
Search Results = Risultati della ricerca
Search and press Enter = Cerca e premi invio
Keywords at least 3 characters = Parole chiave di almeno 3 caratteri
Assembled = Assemblato
Verified = Verificato
In stock = Disponibile
{page} of {pagecount} pages = {page} di {pagecount} pagine
Common Modules = Moduli comuni
User Contributions = Contributi degli utenti
More = Mostra altro
Add Favorite = Aggiungi ai preferiti
Remove Favorite = Rimuovi dai preferiti
Add Sub Part = Aggiungi sotto-parte
Untagged = Senza tag
Package = Contenitore
package = contenitore
Title(PartNO) = Titolo(PartNO)
No Data! = Nessun dato!
Quantity = Quantità
Manufacturer Part = Componente del produttore
manufacturer Part = componente del produttore
Manufacturer = Produttore
manufacturer = produttore
voltage = tensione
Library = Libreria
LCSC Assembled = Assemblato di LCSC
JLCPCB Assembled = Assemblato di JLCPCB
User Contributed = Contributo dell'utente
Symbol = Simbolo
Follow = Segui
Types = Tipi
Classes = Classi
power = alimentazione
Power = Alimentazione
LCSC Part# = Componente# LCSC
Stock = Disponibile
Report Error... = Segnala un errore...
Report Error = Segnala un errore
Thanks for your feedback! = Grazie per il tuo feedback!
Report error success, thanks for your report! = Segnalazione di errore riuscita con successo, grazie!
The content must be at least 2 characters! = Il contenuto deve essere di almeno 2 caratteri!
This library is user contributed, please check before using. = Questa libreria è il contributo di un utente, controlla prima di usarla.
[lib]
All = Tutto
System = Sistema
Personal = Personale
Created = Creato
Favorite = Preferito
No Team found. Please join or create a team first. = Nessun gruppo trovato. Unisciti ad un gruppo o creane uno.
Create a team = Crea un gruppo
No follow user found. Please follow your friend first. = Nessun utente trovato. Segui un tuo amico.
[/lib]


BUY = COMPRA
In Stock = Disponibile
Out of Stock = Esaurito
Minimum = Minimo
Distributor = Fornitore

Capacitance = Capacità
Frequency Tolerance = Tolleranza di frequenza
Power (Watts) = Potenza (Watt)
Power - Max = Potenza - Max
Frequency = Frequenza
Voltage Rating(Vdc,Vac) = Tensione nominale(Vdc,Vac)
Voltage = Tensione
Current Rating = Corrente nominale
Rated current = Corrente nominale
Resistance (Ohms) = Resistenza (Ohm)
Resistance(Ohms) = Resistenza(Ohm)
Inductance = Induttanza
FET Type = Tipo FET
Current Rating(Max) = Corrente nominale(Max)
Impedance @ Frequency = Impedenza @ frequenza
Voltage - Input (Max) = Tensione - Ingresso (Max)
Voltage - Input (Min) = Tensione - Ingresso (Min)
Voltage - Supply = Tensione - Generatore
Voltage - Max = Tensione - Max
Current - Output = Corrente - Uscita

#Dialog Export Your Works
Export your works = Esporta i tuoi lavori
Export to = Esporta in
Zoom = Ingrandisci
Image Type = Tipo di immagine
Qualify =
0 means real size = 0 significa dimensione reale
Merged layer = Strato unito
Separated layer = Strato separato
Paged layer = Strato paginato
Layer = Strato
Export = Esporta
Mirror = Specchio
TopLayer = Strato superiore
BottomLayer = Strato inferiore
TopSilkLayer = Serigrafia strato superiore
Protractor Properties = Proprietà del goniometro
BottomSilkLayer = Serigrafia strato inferiore

BoardOutLine = Linea di contorno della scheda
TopAssembly = Assemblaggio superiore
BottomAssembly = Assemblaggio inferiore
Mechanical = Meccanico
DocumentLayer = Strato del documento
Inner{number} = Inner{number}
Substrate{number} = Substrato{number}
Color = Colore
Full Color =
Canvas Setting = Impostazione canvas
Full Graphics = Grafica completa
Assembly Drawings = Disegni di montaggio
Object Outlines = Contorni degli oggetti
Invalid file format = Formato file non valido
Failed to export file = Impossibile esportare il file
Download now = Scarica adesso
Wire Width = Larghezza del filo
Sheet = Foglio
Merged sheet = Foglio unito
Separated sheet = Foglio separato
Engine = Motore
Exporting PDF = Esporta in PDF
Export 3D Model = Esporta modello 3D
[exportDocument]
Size = Dimensione
[/exportDocument]

#Dialog Import Changes
Confirm Importing changes information = Conferma l'importazione delle informazioni sulle modifiche
You can't undo this operation, Please run a Design Rule Checking (DRC) after this operation. = Non è possibile annullare questa operazione, esegui un Design Rule Checking (DRC) dopo questa operazione.
Apply Changes = Applica le modifiche
This is a simple Design Rule Checking (DRC). = Questo è un semplice DRC.
It just can help you to find the obvious errors = Ti può aiutare a trovare gli errori ovvi
There are some unfinished nets, do you want to check the nets first? = Ci sono delle net incomplete, vuoi controllarle prima?
Yes, Check Nets = Sì, verifica Net
No, Keep Going = No, continua

#Dialog Layer Manager
Configured = Configurato
Layer Name = Nome dello strato
TopPasterLayer =
BottomPasterLayer =
TopSolderLayer =
BottomSolderLayer =
TopPasteMaskLayer =
BottomPasteMaskLayer =
TopSolderMaskLayer =
BottomSolderMaskLayer =
ComponentShapeLayer =
LeadShapeLayer =
ComponentMarkingLayer =
Ratlines =
Ratlines Color =
Manage Colors = Gestisci colori
BoardOutline = Linea di contorno della scheda
Multi-Layer = Multistrato
Hole = Foro
DRCError = Errore DRC
Setting = Impostazioni
Drawing area = Area di disegno
Export area =
Transparency(%) = Trasparenza(%)
Copper Layer = Strato di rame
Signal = Segnale
Plane =
Non-Signal =
Other = Altro
Please delete all the objects of the layers first! The layers are: = Elimina prima tutti gli oggetti degli strati! Gli strati sono:
You are converting Signal Layer to Plane Layer, There're some non-track objects remain on following layers. Please delete the objects manually on the canvas. =
Please delete all the objects of this layer first! = Elimina prima tutti gli oggetti di questo strato!

#Dialog Fabrication Output
Create Files = Crea file
Check your {0}Gerber files{1} carefully before sending them to the factory = Controlla attentamente i tuoi {0}file Gerber{1} prima di inviarli alla fabbrica
Download free Gerber Viewer (gerbv) = Scarica un visualizzatore Gerber gratis (gerbv)
Before generating the Gerber files = Prima di generare i file Gerber
Please check the packages size and orientation carefully. = Controlla attentamente la dimensione dei contenitori e l'orientamento.
Please check for Design Rule Checking (DRC) errors in the Design Manager. = Controlla gli errori del Design Rule Checking (DRC) nel gestore del design.
Please rebuild the copper area after modifying tracks and packages. = Ricostruisci la zona di rame dopo aver modificato le piste e i contenitori.
After generating the Gerber file, please use the {0}Gerber Viewer{1} to check whether it conforms to the design requirements. = Dopo aver generato il file Gerber, utilizza il {0}Visualizzatore Gerber{1} per verificare se è conforme ai requisiti di progettazione.
Order PCB/SMT = Ordina PCB/SMT su JLCPCB
Found the complicated polygon that object cannot be generated at Gerber, please remove or replace = C'è un poligono che non può essere generato su file Gerber, rimuovilo o sostituiscilo
ID: {id}, Object: {object}, Location: {location} = ID: {id}, Oggetto: {object}, Posizione: {location}

#Dialog DRC
Item = Elemento
Value = Valore
value = valore
Unit = Unità
Track Width = Larghezza pista
Track to Track = Da pista a pista
Track to Pad = Da pista a Pad
Pad to Pad = Da Pad a Pad
Via to Via = Da Via a Via
Via Hole Size = Dimensione foro via
Realtime DRC = DRC in tempo reale
{0} is too small! = {0} é troppo piccolo!
Invalid DRC Rule = La regola DRC non è valida
Rule = Regola
Via Diameter = Diametro via
Via Drill Diameter = Diametro foro via
Net List = Elenco net
Rule = Regola
Set Rule = Imposta regola
Check Object to Copper Area = Controlla la zona di rame
Show DRC Boundary while Routing = Mostra il contorno durante lo sbroglio
Check Object to Board Outline = Controlla il contorno della scheda
Rule name already exists! = Il nome della regola é già presente!
You should not delete default rule! = Non puoi eliminare una regola di base!
Rule list contains invalid rule setting! = Alcune regole contengono impostazioni non valide!
Duplicate rule name exists! = Il nome della regola é presente più volte!
via diameter is smaller than via drill diameter! = il diametro via è più piccolo rispetto al diametro del foro!
Currently rule name is not allowed to contain magical characters like . and $ = Al momento i nomi delle regole non possono contenere caratteri del tipo . e $
[drcRule]
All = Tutto
[/drcRule]

#Dialog  Update PCB
Update PCB(Synchronizing PCB from schematics) = Aggiorna PCB(sincronizza PCB dagli schemi)


#Dialog Hotkey
Change Canvas Unit = Cambia unità canvas
Copy Selected Object(s) by Reference Point = Copia gli oggetti selezionati per punto di riferimento
Fullscreen = Schermo intero
Undo the Previous Draw = Annulla il disegno precedente
Set Canvas Origin by Coordinate = Imposta l'origine canvas in base alle coordinate
Switch to the Next Signal Layer = Vai allo strato elettrico successivo
Switch to the Previous Signal Layer = Vai allo strato elettrico precedente
Switch object to top layer or bottom layer = Sposta l'oggetto allo strato superiore o allo strato inferiore
Cycle Forward to the Next Open Tabbed Document = Vai alla scheda successiva
Cycle Backward to the Previous Open Tabbed Document = Vai alla scheda precedente
Switch to the Previous Layer(on the Numeric Keypad) = Vai allo strato precedente (sul tastierino numerico)
Switch to the Next Layer(on the Numeric Keypad) = Vai allo strato successivo (sul tastierino numerico)
Toggle Layers Which is Not Active = Abilita gli strati che non sono attivi
Hotkey Setting = Configurazione dei tasti di scelta rapida
Document Type = Tipo di documento
Shortcut = Scorciatoia
Function = Funzione
ALL = TUTTO
SCH = SCH
Rotate Selected Objects = Ruota gli oggetti selezionati
Scroll or Move Selected Left = Scorri o sposta a sinistra gli oggetti selezionati
Scroll or Move Selected Right = Scorri o sposta a destra gli oggetti selezionati
Scroll or Move Selected Up = Scorri o sposta in alto gli oggetti selezionati
Scroll or Move Selected Down = Scorri o sposta in basso gli oggetti selezionati
Set canvas origin to the center grid of graphics in symbol; Set canvas origin to the center of pads in footprint. =
Cross Document Paste =
Explore & Find Components = Esplora e trova componenti
Select All = Seleziona tutto
Cancel Current Drawing = Cancella il disegno attuale
Save = Salva
Drag Tool = Strumento di trascinamento
Draw Wire = Disegna filo
Draw Bus = Disegna bus
Bus Entry = Bus entry
Junction = Giunzione
Net Flag GND = Etichetta Net GND
Net Flag = Etichetta Net
Draw Polyline = Disegna polilinea
Draw Polygon = Disegna poligono
Draw Bezier = Disegna curva di Bezier
Draw Arc = Disegna arco
Draw Rect = Disegna rettangolo
Draw Ellipse = Disegna ellisse
Freehand Draw = Disegno a mano libera
Freedraw = Disegno libero
Draw Text = Disegna testo
Edit Selected Symbol = Modifica il simbolo selezionato
Draw Track = Disegna pista
Draw Circle = Disegna cerchio
Cycle Select Object at Current Location = Scorri l'oggetto selezionato nella posizione corrente
Draw Dimension = Disegna dimensione
Draw Connect = Disegna connessione
Draw CopperArea = Disegna zona di rame
Change to TopLayer;<br/>Change Selected Component's Layer to TopLayer; =
Change to BottomLayer;<br/>Change Selected Component's Layer to BottomLayer; =
Change to Inner1 = Passa a Inner1
Change to Inner2 = Passa a Inner2
Change to Inner3 = Passa a Inner3
Change to Inner4 = Passa a Inner4
Highlight Net = Evidenzia Net
Place Pad = Posiziona Pad
Place Via = Posiziona Via
Measure = Misura
Change Routing Angle =
Change Routing Conflict =
Decrease Routing Width =
Increase Routing Width =
Decrease Snap Size = Diminuisci la spaziatura aggancio
Increase Snap Size = Aumenta la spaziatura aggancio
Change Copper Zone Visible or Invisible = Modifica la zona di rame in visibile o non visibile
Rebuild All Copper Area = Ricostruisci tutta la zona di rame
Toggle PCB Net Display =
Show Property Dialog When Placing Object;<br/>Show Location Setting Dialog When Pasting Object(s) = Mostra la finestra di dialogo degli attributi quando si posiziona l'oggetto;<br/>Mostra la posizione della finestra di dialogo quando si incollano gli oggetti
Show Property Dialog When Placing Object;<br/>Show Absolute Offset Dialog When Selecting Object(s);<br/>Show Location Setting Dialog When Pasting Object(s) =
Show Relative Offset Dialog When Selecting Object(s) =
Open the FAQ Page = Apri la pagina delle FAQ
Move Object(s) by Reference Point = Sposta oggetto/i per punto di riferimento
Choose Favorite Track Width While Routing = Scegli la larghezza preferita della pista durante lo sbroglio
Copy Selected Object(s) and Paste Repeatedly = Copia gli oggetti selezionati ed incollali ripetutamente

#My Projects Tree Menu
New Project = Nuovo progetto
New Schematic = Nuovo schema
New PCB = Nuovo PCB
New Spice Subckt = Nuovo sottocircuito Spice
Modify = Modifica
Delete = Elimina
Add sub part = Aggiungi sotto-parte
Clone = Duplica
Version History = Cronologia della versione
Refresh List = Aggiorna la lista
Create New Project = Crea un nuovo progetto
Delete = Elimina
Attachment = Allegato
Archive = Archivia
Transfer = Trasferisci
Manage Project = Gestisci progetto

#Dialog Verify Package
Footprints Verification = Verifica Footprint

#Dialog Edit Polygon Pad points
Edit Points = Modifica punti
Center point is outside the pad = Il punto centrale è fuori dal pad
Hole should be inside the pad = Il foro dovrebbe essere all'interno del pad
Hole is draggable = Il foro è trascinabile

#My Part Tree Menu
Clone = Duplica
Reload parts = Ricarica componenti
Layers = Strati

#Dialog Preferences
Language = Lingua
Display Name = Mostra nome
HotKey Sync = Sincronizzazione dei tasti di scelta rapida
My Theme Sync = La mia sincronizzazione del tema
Document Recovery Setting = Impostazioni per il recupero dei documenti
Enable auto backup = Abilita backup automatico
Maximum backup level = Livello massimo di backup
Auto backup interval = Intervallo automatico di backup
minutes = minuti
Save to Server = Salva sul server
Load from Server = Carica dal server


#Dialog Schematic Library Wizard
Symbol Wizard = Procedura guidata dei simboli
Style = Stile
Picture = Immagine
Pin Names = Nomi dei pin
Contributor = Contributore
contributor = contributore
owner = proprietario

#Dialog Annotate
Annotate = Annota
Scope =
Active Schematic only = Solo schema attivo
All Opened Schematics = Tutti gli schemi aperti
Method = Metodo
Re-annotate all = Riannota tutto
Keep existing annotation = Mantieni l'annotazione esistente
Direction = Direzione
Rows = Righe
Cols = Colonne
Reset = Reimposta

#Dialog Order
Order... = Ordina...
PCB Qty. = Quantità di PCB
PCB Thickness = Spessore del PCB
PCB Dimension = Dimensione del PCB
Automatic calculation = Calcolo automatico
PCB Color = Colore del PCB
Green = Verde
White = Bianco
Blue = Blu
Red = Rosso
Yellow = Giallo
Black = Nero
Purple = Viola
Copper = Ramato
Gold = Oro
Silver = Argento
Surface Finish = Finitura superficiale
Hasl = Hasl
Hasl(Lead Free) = Hasl(senza piombo)
ENIG = ENIG

#Dialog Hot Key config
Restore All Default Shortcuts = Ripristina tutte le scorciatoie predefinite
Save Changes = Salva le modifiche



#Dialog Polyline Maybe Wire
To connect electrical elements, please use Wire (W hotkey) and not Line (L hotkey). = Per connettere gli elementi elettrici, usa filo (tasto di scelta rapida W) e non linea (tasto di scelta rapida L).

Anonymous File = File anonimo
Anonymous File can not be cloned, but you can open it, then save it as a new file. = Un file anonimo non può essere duplicato, ma puoi aprirlo e salvarlo come nuovo file.
Free Documents = Documenti gratuiti
You must close the file before delete it! = Devi chiudere il file prima di eliminarlo!
Offline Project = Progetto offline

#Message box
Confirmation = Conferma
Alert = Attenzione 
Information = Informazione
information = informazione
Prompt = Immissione dati
Error = Errore
error = errore
error! = errore!
Warning = Attenzione
Imported ok! = Importazione riuscita con successo!
Some changes have not been saved. = Alcune modifiche non sono state salvate.
Your file hasn't been saved. Please save first! = Il tuo file non è stato salvato. Salvalo prima!
Your file hasn't been saved. Are you sure you want to close it? = Il tuo file non è stato salvato. Sei sicuro di volerlo chiudere?
Error! Please try again later. = Errore! Riprova più tardi.
Are you sure you want to reload this page? = Sei sicuro di voler ricaricare questa pagina?
Are you sure you want to leave this page? = Sei sicuro di voler lasciare questa pagina?
Confirm Reload = Conferma ricarica
Confirm Close = Conferma chiusura
Reload this page = Ricarica questa pagina
Leave this page = Lascia questa pagina
Stay on this page = Resta su questa pagina
Don't reload = Non ricaricare
No connect flag only can be placed on Pin dot or the wire which is connected one Pin. =
can not be placed on the wire which is placing No Connect Flag. =
The footprint transfer to LCSC library class successfully = Il trasferimento del footprint alla classe della libreria LCSC è andato a buon fine
Device/Footprint goes into "SMT Device/Footprint Verified" list successfully = Il dispositivo/footprint va in "Dispositivo SMT/Footprint verificato"

Load failure! = Impossibile caricare!
Load projects failed = Impossibile caricare i progetti
error info = info sull'errore
error information = informazioni sull'errore
Guest can't create a new project. Please login! = L'utente ospite non può creare un nuovo progetto, accedi!
Please create a project before you do this! = Crea un progetto prima di fare questo!
Add Part success = Aggiunto componente con successo
Click the new part and then edit it! = Clicca sul nuovo componente e modificalo!
Delete my work = Cancella il mio lavoro
Delete my work. (Only deletes it from this list but not from the server) = Cancella il mio lavoro. (Lo elimina solo da questo elenco ma non dal server)
Do you confirm this? = Confermi?
Successfully deleted! = Eliminato con successo!
Successfully Copied! = Copiato con successo!
Cloning success! = Duplicato con successo!
Your title is too short! = Il tuo titolo è troppo corto!
Remove this part = Rimuovi questo componente
Find and Jump to ... = Trova e salta a ...
Please type the prefix, such as U1, R1, C1 = Digita il prefisso, ad esempio U1, R1, C1
Zoom as 1:1, you can print it and then create artwork for etching the PCB. = Zoom 1:1, puoi stamparlo e quindi creare la grafica per incidere il PCB.
Exporting your works! = Sto esportando i tuoi lavori!
Guests can't import a file. Please login! = Gli utenti ospiti non possono importare file. Accedi!
Please create a project before you import a file! = Crea un progetto prima di importare un file!
Import your LTspice file! = Importa il tuo file LTspice!
Open LTspice file = Apri il file LTspice
Please make sure the selected LTspice file is a file saved in LTspice V and above. = Assicurati che il file LTspice selezionato sia un file salvato in LTspice V o versioni successive.
Saved successfully! = Salvato con successo!
Save failed! = Impossibile salvare!
Can not place parts into this document. = Impossibile posizionare i componenti in questo documento.
User Package = Contenitore dell'utente
System Package = Contenitore di sistema
File error = Errore del file
Please save your file first! = Prima salva i tuoi file!
Email address is too short! = L'indirizzo email è troppo corto!
You have not selected a file to upload. = Non hai selezionato alcun file da caricare.
Update = Aggiorna
No changes, the PCB already matches the schematic! = Nessuna modifica, il PCB corrisponde già allo schema!
Only public files can be shared = Solo i file pubblici possono essere condivisi
Conversion to PCB has failed! = Impossibile creare il PCB!
Your username is too short! = Il tuo nome utente è troppo corto!
Your password is too short, it must be more than 6 characters! = La tua password è troppo corta, deve contenere più di 6 caratteri!
Conflicting shortcut = Scorciatoia in conflitto
There is an empty PCB file. Please first run Convert Schematic to PCB... from the schematic = C'è un file PCB vuoto. Per prima cosa, esegui converti schema in PCB... dallo schema
This file has been modified, are you sure you want to run this simulation before saving it first? = Questo file è stato modificato, sei sicuro di voler eseguire questa simulazione prima di salvarla?
Please enter the Maximum Timestep! = Inserisci lo step di tempo massimo!
Please enter the Stop Time! = Inserisci il momento di Stop!
All of these fields are needed. = Tutti questi campi sono obbligatori.
Either your spice netlist is too big or the server is busy. Please try again later. = La tua netlist di spice è troppo grande o il server è occupato. Riprova più tardi.
Your spice netlist is too big! Try breaking your circuit into smaller simulatable blocks. = La tua netlist di spice è troppo grande! Prova a suddividere il tuo circuito in blocchi più piccoli e simulabili.
Too many users in simulation. Please try again later! = Troppi utenti in simulazione. Riprova più tardi!
Due to limited server resources, please wait 10 seconds for the interval in every time simulation. = A causa delle risorse limitate del server, attendere 10 secondi tra una simulazione e l'altra.
Your circuit is too complex, we have not enough CPU resource to support this simulation, please reduce your circuit as small as you can. = Il tuo circuito è troppo complesso, non abbiamo abbastanza risorse per supportare questa simulazione, riduci il circuito il più possibile.
Simulation is queuing, try again after 30s. = La simulazione è in attesa, riprova tra 30 secondi.
Timeout = Tempo scaduto
Demo accounts don't support simulation, please login first = Gli account demo non supportano la simulazione, accedi prima di proseguire
Please login first = Accedi prima di proseguire
The schematic is showing errors, please check the simulation report carefully! = Lo schema mostra degli errori, controlla attentamente il rapporto di simulazione!
Simulation too long, maybe your schematic is too complex. = Simulazione troppo lunga, forse il tuo schema è troppo complesso.
Non-simulated file = File non simulato
This file can only be opened in standard mode. To open it, please switch to standard mode. = Questo file può essere aperto solo in modalità standard. Per aprirlo, passa alla modalità standard.
Load your preferences success! = Le tue preferenze sono state caricate!
Save your preferences success! = Le tue preferenze sono state salvate!
Update subckt ok! = Il sottocircuito è stato aggiornato!
Clone your file = Duplica il file
Please type a new file name = Inserisci un nuovo nome del file
Create file failure! = Impossibile creare il file!
Schematics and PCBs can't be imported under My Libs folder, please choose a different folder = Schemi e PCB non possono essere importati nella cartella My Libs, scegli una cartella diversa
Libraries to be imported under My Libs folder = Librerie da importare nella cartella My Libs
Please choose only the libraries needed = Scegli solo le librerie necessarie
Maximum import is 200 libs at one time! = Si possono importare fino a 200 librerie per volta!
You libraries will be found under the My Libs folder = Le tue librerie si trovano nella cartella My Libs
Add to Library = Aggiungi alla libreria
No items have been checked! = Nessun oggetto è stato controllato!
Nothing was found, please create it for yourself = Non è stato trovato nulla, crealo tu stesso
Search result = Risultato della ricerca
At least 3 characters needed = Sono necessari almeno 3 caratteri
Add to my Favorite Parts = Aggiungi componenti ai miei preferiti
Added it OK. Please find it in your Favorite Parts = Aggiunto. Lo trovi nei tuoi componenti preferiti
Please select its parent node = Seleziona il nodo padre
Libraries can not be exported as active project pdf. = Le librerie non possono essere esportate come pdf di un progetto attivo.
Error:No GND = Errore: nessuna GND
This circuit does not have GND. Please select GND from the circuit tool to add to the circuit. = Questo circuito non presenta alcuna GND. Seleziona una GND dallo strumento del circuito da aggiungere al circuito.
Current circuit doesn't has Voltage Resource or Current Resource symbol, please place it first at left side EElib or Spice Library. =
Probe can not connect with ground(GND)! = La sonda non può essere collegata alla terra(GND)!
Spice symbols's properties can't be empty. = Le proprietà dei simboli Spice non possono essere vuote.
Error:No Spice Symbol = Errore: nessun simbolo Spice
Simulation limit = Limite della simulazione
There is a multimeter in the circuit that needs to be simulated using the emulation command .tran or .op = C'è un multimetro nel circuito che deve essere simulato utilizzando il comando di emulazione .tran o .op
An oscilloscope exists in the circuit and needs to be simulated using the simulation command .tran = C'è un oscilloscopio nel circuito e deve essere simulato utilizzando il comando di simulazione .tran
There are components in this circuit that do not have a simulation model. Please use the base library component of the simulation mode for simulation. = Ci sono componenti in questo circuito che non hanno un modello di simulazione. Per la simulazione, utilizza il componente della libreria di base della modalità di simulazione.
Circuit does not have a probe = Il circuito non ha sonde
Make sure your pin numbers are even numbers = Assicurati che il numero di pin sia pari
Duplicate Components Prefix = Il prefisso dei componenti è già presente
All components are hidden successfully! = Tutti i componenti sono stati nascosti!
All ratlines are hidden successfully! = Tutte le linee di collegamento sono state nascoste
Hidden the ratline of net {netName} successfully! = Linee di collegamento della net {netName} nascoste!
Duplicate Component Prefix = Il prefisso del componente è già presente
{0} exist = {0} esiste
There are some invalid packages, are you sure? = Ci sono alcuni contenitori errati, sei sicuro?
Invalid Characters, library only allows [0-9a-zA-Z-_] = Caratteri non validi, la libreria consente solo [0-9a-zA-Z-_]
Annotation success = Annotazione riuscita
If you accept this annotation operation, please save your files. If not, close your files without saving. = Se accetti questa operazione di annotazione, salva i tuoi file. In caso contrario, chiudi i file senza salvare.
This file can't be saved under libs project. Please choose other project or create a new project = Questo file non può essere salvato nel progetto libs. Scegli un altro progetto o crea un nuovo progetto
Your file is unsaved. = Il tuo file non è stato salvato.
You can close the editor now. Have a good day! = Ora puoi chiudere l'editor. Buona giornata!
Successfully logged out = Uscita avvenuta con successo
You have at least one unsaved file open. Please save it or close it. = Hai almeno un file aperto che non è stato salvato. Salvalo o chiudilo.
Please select a reference point = Seleziona un punto di riferimento
Please save your file before this operation = Prima di effettuare questa operazione, salva il tuo file
Please open a PCB document = Apri un documento PCB
Please save your file before '{0}'. = Prima salva il tuo file '{0}'.
Please try again after saving this file. = Prova di nuovo dopo aver salvato questo file.
This text can not be empty! = Questo testo non può essere vuoto!
Export to Altium fail, please try again or contact us. = Impossibile esportare in Altium, prova di nuovo oppure contattaci.
Connecting to server = Connessione al server
Please login before asking for help = Effettua l'accesso prima di chiedere aiuto
This file has been modified, please save it first! = Il file è stato modificato, salvalo!
Remove this param = Rimuovi questo parametro
You cannot drag a part to the canvas, please click the part and move the cursor to the canvas and then right-click to place. = Non è possibile trascinare un componente sull'area di disegno. Fai clic sul componente e sposta il cursore sull'area di disegno, quindi premi il tasto destro del mouse per posizionarlo.
Undo/Redo temporary error = Annulla/Ripristina errore temporaneo
We are sorry but there is an unpredictable error in the undo/redo process. This problem will be fixed soon but in the meanwhile it is safe to continue working on your design. = Siamo spiacenti ma si è verificato un errore imprevisto durante il processo di annullamento/ripristino. Questo problema verrà risolto presto, ma nel frattempo puoi continuare a lavorare sul tuo progetto.
The schematic has duplicate prefixes of the components, please make them unique. You can check them using the Design Manager. = Lo schema presenta prefissi duplicati dei componenti, rendili unici. Puoi controllarli utilizzando il gestore del design.
Found duplicated prefix components, can not Import Changes, please modify the duplicated prefix or delete related component. = Sono stati trovati componenti con il prefisso duplicato, impossibile importare le modifiche. Modifica il prefisso duplicato oppure elimina il relativo componente.
Please click the below help button to find out how to fix this problem. = Clicca sul pulsante di aiuto sottostante per scoprire come risolvere questo problema.
Please create a board outline! Click the help button to find out how to create a board outline. = Crea il contorno della scheda! Clicca il buttone aiuto per scoprire come crearlo.
Can not fetch files from server, please check your network and try again = Impossibile recuperare i file dal server, controlla la tua rete e riprova
Please open a schematic first! = Apri prima uno schema!
Can not find the schematic of this PCB = Impossibile trovare lo schema di questo PCB
invalid points! = punti non validi!
This file does not support this operation. = Questo file non supporta questa operazione.
Net Name Conflict = Conflitto nome net
Net name = Nome net
{0} are in the same wire, please remove others and just keep one. = {0} sono sullo stesso filo, rimuovi gli altri e lasciane solo uno.
This field can't be removed! = Questo campo non può essere rimosso!
Annular ring of the pad/via is too small = Anello del pad/via troppo piccolo
The size of the hole cannot exceed the size of the pad = La dimensione del foro non può superare la dimensione del pad
Are you sure you want to create a multi-sheet designs? = Sei sicuro di voler creare uno schema a più fogli?
Are you sure you want to create a {0}multi-sheet designs{1}? = Sei sicuro di voler creare uno {0}schema a più fogli{1}?
Please build the copper area! Click the help button to find out how to build the copper area. = Costruisci la zona di rame! Clicca sul pulsante di aiuto per scoprire come costruire la zona di rame.
Suggest to set a package for this component first! = Suggerisci di impostare prima un contenitore per questo componente!
Please select an opened document first. = Seleziona prima un documento aperto.
Some files failed to load. Please reload the page. = Impossibile caricare alcuni file. Ricarica la pagina.

#UI Intro
Skip = Salta
« Back = « Precedente
Next » = Successivo »
Done = Chiudi
This is the user management menu. = Questo è il menu di gestione degli utenti.
This is the toolbar. = Questa è la barra degli strumenti.
This is the navigation list. Under here you can find projects, files, parts and libraries. = Questa è la lista di navigazione. Qui sotto puoi trovare progetti, file, componenti e librerie.
Show or hide the toolbar to the top of the window here. = Mostra o nascondi la barra degli strumenti nella parte superiore della finestra.
Show, resize or hide the left sidebar to the left of the window here. = Mostra, ridimensiona o nascondi la barra laterale sinistra della finestra.
Show or hide the right sidebar to the right of the window here. = Mostra o nascondi la barra laterale destra della finestra.

#Standard libs
Passive Components = Componenti passivi
Power Supply = Alimentazione elettrica
Diodes = Diodi
Regulator = Regolatore
Transistor = Transistor
Transformers = Trasformatori
Gates = Porte
Vacuum Tubes = Tubi a vuoto
Switch = Interruttore
Relay = Relè
Capacitor(US) = Condensatore(US)
Capacitor(EU) = Condensatore(EU)
Capacitor(EU)2 = Condensatore(EU)2
Electrolytic Capacitor(US) = Condensatore elettrolitico(US)
Electrolytic Capacitor(EU) = Condensatore elettrolitico(EU)
Electrolytic Capacitor(US)2 = Condensatore elettrolitico(US)2
Electrolytic Capacitor(EU)2 = Condensatore elettrolitico(EU)2
Inductor(US) = Induttore(US)
Inductor(EU) = Induttore(EU)
Potentiometer_US = Potenziometro_US
Potentiometer_EU/IEC = Potenziometro_EU/IEC
Potentiometer_3D = Potenziometro_3D
Resistor(US) = Resistore(US)
Resistor(EU) = Resistore(EU)
Resistor 45 Deg(US) = Resistore 45 Deg(US)
Resistor 45 Deg(EU) = Resistore 45 Deg(EU)
Variable Capacitor(US) = Condensatore variabile(US)
Variable Capacitor(EU) = Condensatore variabile(EU)
Variable Resistor(US) = Resistore variabile (US)
Variable Resistor(EU) = Resistore variabile (EU)
Variable Inductor(US) = Induttore variabile (US)
Variable Inductor(EU) = Induttore variabile (EU)
Varistor = Varistore
Inductor2(US) = Induttore2(US)
Inductor2(EU) = Induttore2(EU)
Battery = Batteria
Voltage Source = Generatore di tensione
Current Source = Generatore di corrente
CCCS(Current Controlled Current Source) = CCCS(Sorgente di corrente controllata in corrente)
CCCS2(Current Controlled Current Source) = CCCS2(Sorgente di corrente controllata in corrente)
VCCS(Voltage Controlled Current Source) = VCCS(Sorgente di corrente controllata in tensione)
VCVS(Voltage Controlled Voltage Source) = VCVS(Sorgente di tensione controllata in tensione)
CCVS(Current Controlled Voltage Source) = CCVS(Sorgente di tensione controllata in corrente)
CCVS2(Current Controlled Voltage Source) = CCVS2(Sorgente di tensione controllata in corrente)

BV(Behavioral Voltage Sources) = BV(Sorgenti di tensione comportamentali)
BI(Behavioral Voltage Sources) = BI(Sorgenti di tensione comportamentali)
Epoly(Non-linear Voltage Source) = Epoly(Sorgente di tensione non lineare)
Gpoly(Non-linear Current Source) = Gpoly(Sorgente di corrente non lineare)

Diode = Diodo
LED = LED
LED_3D = LED_3D
Schottky Diode = Diodo Schottky
Varactor Diode = Diodo varicap
Zener = Zener
Unidirectional TVS Diode = Diodo TVS unidirezionale
Bidirectional TVS Diode = Diodo TVS bidirezionale
Diac = Diac
Bridge = Ponte
78XX = 78XX
79XX = 79XX
LM317 = LM317
LM337 = LM337
TL431 = TL431
BJT(NPN) = BJT(NPN)
BJT(PNP) = BJT(PNP)
MOSFET(Nch) = MOSFET(Nch)
MOSFET(Nch) Depletion Four-pins = MOSFET(Nch) Depletion quattro pin
MOSFET(Nch) Enhancement = MOSFET(Nch) Enhancement
MOSFET(Nch) Enhancement Four-pins = MOSFET(Nch) Enhancement quattro pin
MOSFET(Pch) = MOSFET(Pch)
MOSFET(Pch) Depletion Four-pins = MOSFET(Pch) Depletion quattro pin
MOSFET(Pch) Enhancement = MOSFET(Pch) Enhancement
MOSFET(Pch) Enhancement Four-pins = MOSFET(Pch) Enhancement quattro pin
JFET(Nch) = JFET(Nch)
JFET(Pch) = JFET(Pch)
Darlington NPN = NPN darlington
Darlington PNP = PNP darlington
MESFET(Nch) = MESFET(Nch)
MESFET(Pch) = MESFET(Pch)

IGBT = IGBT
SCR = SCR
Triac = Triac
Transform(US) = Trasformatore(US)
Transform(EU) = Trasformatore(EU)
Transfrom(NEUTRAL-CTR TAP)(US) = Trasformatore(NEUTRAL-CTR TAP)(US)
Transfrom(NEUTRAL-CTR TAP)(EU) = Trasformatore(NEUTRAL-CTR TAP)(EU)
Mutual Inductors =
Mutual Inductors2 =
Or Gate = Porta or
Xor Gate = Porta xor
And Gate = Porta and
Nor Gate = Porta nor
Nand Gate = Porta nand
Not Gate = Porta not
Xnor Gate = Porta xnor
Tube Diode = Diodo a tubo
Tube Triode = Triodo a tubo
Tube Tetrode = Tetrodo a tubo
Tube Pentode = Pentodo a tubo
Voltage Controlled Switch = Interruttore controllato in tensione
Current Controlled Switch = Interruttore controllato in corrente
SPST ON = SPST ON
SPST OFF = SPST OFF
Fuse = Fusibile
555 = 555
555(Style2) = 555(stile2)
Speaker = Altoparlante
XTAL = XTAL
5pin Operational Amplifier = Amplificatore operazionale a 5 pin
3pin Operational amplifier = Amplificatore operazionale a 3 pin
Transmission Line = Linea di trasmissione
Voltmeter = Voltmetro
Ammeter = Amperometro
LAMP = LAMPADINA
Opto Transistor = Opto-Isolatore

#Server Message
Need login = È necessario accedere
Bad password = Password errata
We can't find your username or your email, please check it! = Nome utente o email non trovata, riprova!
Make sure your uploaded file size is less than 3MB! = La dimensione del file caricato deve essere inferiore a 3MB!
Bad file type = Tipo di file non valido
Empty file or bad file type, ensure your file is Eagle 6.0+ = File vuoto o tipo di file non valido, assicurati che il tuo file provenga da Eagle v6.0 o successiva
This operation not supported on demo account = Questa operazione non è supportata sull'account demo
Can not share this file under a private project, please set the active project to public! = Impossibile condividere questo file con un progetto privato, imposta la visibilità del progetto come pubblica!
Login Failed Too many attempts. If you forgot your password, please {0}reset your password{1} or send an email to support@easyeda.com = Accesso non riuscito, troppi tentativi falliti. Se hai dimenticato la password, {0}reimpostala{1} oppure invia un'email a support@easyeda.com

#Dialog Common Buttons
Common Buttons Setting = Impostazione dei pulsanti comuni
Menu Setting... = Impostazione del menu...
Show/Hide = Mostra/Nascondi
Move Up = Sposta su
Move Down = Sposta giù
Reset All = Reimposta tutto
Zoom = Zoom
Place Pin = Posiziona pin

#System Setting Dialog
System = Sistema
Zoom Mode = Modalità zoom
Scroll Key = Tasto di scorrimento
CTRL + Scroll = CTRL + Rotella del mouse
Canvas Coordinate System = Sistema di coordinate canvas
SVG Coordinate = Coordinate SVG
Cartesian Coordinate = Coordinate cartesiane
Open Wizard Dialog for New Schematic = Apri la procedura guidata di un nuovo schema
Default Unit = Unità predefinita
Canvas Zoom Effect = Effetto zoom canvas
Quality Priority = Priorità di qualità
Speed Priority = Priorità di velocità
Rotation Step = Passo di rotazione
Add Teardrop Automatically = Aggiungi teardrop automaticamente
Assign Net for Free Track/Arc/Circle = Assegna una net per pista/arco/cerchio
Open Wizard Dialog for New PCB = Apri la procedura guidata di un nuovo PCB
Rebuild Plane Automatically = Ricostruisci aree automaticamente
The Track's Routing Follows Component's Rotation = Lo sbroglio della pista segue la rotazione del componente
Display Pad's Number and Net = Mostra numero di pad e net
Favorite Track width = Larghezza della pista preferita
Track Width Setting = Impostazione larghezza della pista


#Dialog Access Control
Permissions = Permessi
Operations = Operazioni
Access Control = Controllo di accesso
Project Access Control = Controllo dell'accesso al progetto
Reject = Rifiuta
Add User = Aggiungi utente
Bad email address = Indirizzo email non corretto
# error info from backend
Can't find this email address in EasyEDA. Your partner must be an EasyEDA user. = Indirizzo email non è associato ad un alcun utente registrato in EasyEDA.

#Dialog waveForm
Grid Background = Sfondo della griglia
Pane Background = Sfondo del pannello
WaveForm Config = Configura forma d'onda
Export Waveform = Esporta forma d'onda


#attr-canvas-grid-style
dot = punto
line = linea

#attr-canvas-frame-size
Other = Altro
A4 Portrait = A4 verticale
A4 Landscape = A4 orizzontale
A3 Portrait = A3 verticale
A3 Landscape = A3 orizzontale
A2 Portrait = A2 verticale
A2 Landscape = A2 orizzontale
A1 Portrait = A1 verticale
A1 Landscape = A1 orizzontale
Landscape = Orizzontale
Portrait = Verticale

#Stroke Style
solid = solido
dashed = tratteggiato
dotted = punteggiato

#Solid Region
Solid Region = Regione solida
Type = Tipo
type = tipo

#Dialog Libs Management
Report error = Segnala un errore
Please give us some information to help us find the problem. = Fornisci alcune informazioni per aiutarci a identificare il problema.
Cannot place parts into this document: Schematic Symbols can only be placed into a Schematic; PCB Footprints can only be placed into a PCB. = Impossibile posizionare componenti in questo documento: i simboli degli schemi possono essere posizionati solo in uno schema e i footprint possono essere inserite solo in un PCB.
Save it as a favorite part = Salvalo come componente preferito
Only logged-in users can save this component as a Favorite Part but guest (Anonymous) users can place this component into their design directly. Would you like to place this component now? = Solo gli utenti che hanno effettuato l'accesso possono salvare questo componente come preferito, ma gli utenti ospiti (anonimi) possono inserire questo componente direttamente nel loro progetto. Vuoi posizionare adesso questo componente?

#Others
Find libs = Trova librerie
My Projects = I miei progetti
My Parts = I miei componenti
My Modules = I miei moduli
Assembly LCSC Components = Assemblaggio componenti LCSC
Modules = Moduli
SCH Module = Modulo SCH
PCB Module = Modulo PCB
System IC = IC del sistema
LCSC (Official) = LCSC (Ufficiale)
LCSC Electronics = LCSC Elettronica
Simple Mode = Modalità semplice
Expand Mode = Modalità estesa
Help Verify = Aiuta a verificare
Favorite Parts = Componenti preferiti
Shared With Me = Condivisi con me
Preview = Anteprima
Preview Window = Finestra anteprima
System Default = Predefinito di sistema
User Defined = Definito dall'utente
Theme = Tema
Theme Setting = Impostazioni del tema
Close = Chiudi
Open = Apri
Toggle toolbar = Abilita la barra degli strumenti
Toggle left bar = Abilita la barra a sinistra
Toggle right bar = Abilita la barra a destra
Reload = Ricarica
Mouse-X = Mouse-X
Mouse-Y = Mouse-Y
Mouse-DX = Mouse-DX
Mouse-DY = Mouse-DY
Bus entry x1 = Bus entry x1
Bus entry x2 = Bus entry x2
Bus entry y1 = Bus entry y1
Bus entry y2 = Bus entry y2
Yes = Sì
No = No
OK = OK
Confirm = Accetta
Continue = Continua
Cancel = Annulla
Update = Aggiorna
Bus entry = Bus entry
Filter = Filtro
Check = Verifica

Copy the contents of this box into a text editor, then save the file. Paste the edited text back into this box and click Apply to update the display. = Copia il seguente contenuto in un editor di testo e salvalo. Dopo averlo modificato, copialo nuovamente all'interno di questa casella di testo e premi Applica per aggiornare il display.
Copy the contents of this box into a text editor, then save the file with a .svg extension. You can edit it in Inkscape or open it in your browser. = Copia il seguente contenuto in un editor di testo e salvalo con l'estensione .svg. Puoi modificarlo con Inkscape o aprirlo con il tuo browser.
Content is too big to show, you can download it directly. = Il contenuto è troppo grande per essere visualizzato, puoi scaricarlo direttamente.
SVG format = Formato SVG
SVG File = File SVG
Description should be no more than 250 letters = La descrizione non deve superare i 250 caratteri
The file save operation has timed out. Try again and check your Internet connection. = Il tempo per l'operazione di salvataggio é scaduto. Riprova e verifica la tua connessione internet.
Export Netlist = Esporta Netlist
Notifications = Notifiche
Please select txt or json files. = Seleziona dei file txt o json.
Failed to read file [{file}] = Impossibile leggere il file [{file}]
[{file}] is not a valid json file = [{file}] non è un file json valido
Invalid parameters! = Parametri errati!
Download = Scarica
Start = Avvia
You have unsaved files, are you sure you want to log out without saving the files? = Ci sono dei file non salvati, sei sicuro di voler uscire senza salvarli?
Please use the web version to run this function. = Questa funzione è disponibile solo nella versione web.
Please save this file to you project! = Salva questo file nel tuo progetto!
Nothing changed = Nessuna modifica effettuata
Delete Node = Elimina nodo
This layer is invisible. = Questo strato é invisibile.
When the solid region is Board Cutout, please set the layer to Multi-Layer. = Se la regione solida è di tipo Ritaglio della scheda, imposta lo strato come Multistrato.
You should not try to assign a net to a Board Cutout solid region. = Non assegnare una net ad un Ritaglio della scheda.
Net Length = Lunghezza net
You can place a Pin in the schematic, but don't forget to group all of the Pins to a schematic component. Please click the help button to find out how to group them. If you just want to mark the wire, please use NetPort or NetLabel. = Puoi posizionare un pin nello schema, ma non dimenticarti di raggruppare tutti i pin nello schema del componente. Premi il pulsante help per scoprire come raggrupparli. Se vuoi semplicemente marcare il filo, usa NetPort o NetLabel.
Please input the modification = Inserisci la modifica
The content must be between {0} and {1} characters = Il contenuto deve contenere tra i {0} e {1} caratteri

Coming soon = Prossimamente in arrivo
No tool = Nessuno strumento
Help us translate into your language = Aiutaci a tradurre nella tua lingua
Pad = Pad
Via/Hole = Via/Foro
PCB Layers = Strati PCB
Order PCB = Ordina PCB
Share = Condividi
Free = Gratuito
Small = Piccolo
Medium = Medio
Big = Grande


Embed = Embed
HTML = HTML
URL = URL
BBCode = BBCode
PNG = PNG
Exporting as = Esporta come
Exporting as image = Esporta come immagine
Exporting as {0}SVG{1} file. = Esporta come file {0}SVG{1}.
Exporting as pdf is recommended: pdf gives good quality printed output and a small file size. = Si consiglia di esportare in PDF: produce una buona qualità di stampa e occupa poco spazio.
Generate PCB Fabrication File(Gerber) = Genera file di fabbricazione PCB(Gerber)
PenWidth-Increase =

#Generate Gerber
Generate Gerber = Genera Gerber
Gerber View = Visualizza Gerber
Dimensions(Estimated) = Dimensioni(Stima)
PCB Qty = Quantità di PCB
Copper Weight = Spessore del rame
PCB Price = Prezzo del PCB
Estimated Delivery Time = Tempo di consegna stimato

HASL(with lead) = HASL(con piombo)
LeadFree HASL-RoHS = Senza piombo HASL-RoHS
ENIG-RoHS = ENIG-RoHS
Would you like to do Design Rule Checking (DRC) before generating the Gerber files? = Vuoi eseguire la Regola di Controllo di Design (DRC) prima di generare i file Gerber?
Yes, Check DRC = Sì, controlla DRC
No, Generate Gerber = No, genera Gerber
This PCB has uncompleted connection(s), do you want to check the connection(s)? = Questo PCB contiene una connessione o più connessioni incomplete, le vuoi controllare?
Yes, Check Connection(s) = Sì, controlla connessione/i
It will then redirect to the web site of a third-party JLCPCB with which we cooperate. Are you ready? = Sarai, quindi, reindirizzato al sito Web esterno di JLCPCB con cui collaboriamo. Sei pronto?
Failed to submit your order, please contact us via support@easyeda.com for help. = Impossibile inviare il tuo ordine, contattaci tramite support@easyeda.com per risolvere il problema.
Failed to submit your order, please contact us via QQ 800821856. = Impossibile inviare il tuo ordine, contattaci tramite QQ 800821856.
Order data generated finish, please click OK button and continue. = I dati dell'ordine sono stati generati, clicca su OK per continuare.
[generateGerber]
Layers = Strati
[/generateGerber]

[version]
Switch = Cambia
[/version]


Export your file, then print it yourself. = Esporta il file, quindi stampalo.
Trace width is too small = La larghezza della pista é troppo piccola
Share = Condividi

Images Property = Proprietà delle immagini
Connect Pad to Pad = Connetti da Pad a Pad
Copper Area = Zona di rame
Dimension = Dimensione


Please check that you have used Wire and not Line to connect electrical elements. = Controlla di aver usato un Filo e non una Linea per connettere i componenti elettrici.
PCB Fabrication Prices & capabilities = Prezzo & Capacità di produzione PCB
Flip all texts on bottom layer = Capovolgi tutti i testi sullo strato inferiore
Create New Document = Crea nuovo documento
General Package = Contenitore generale
General Packages = Contenitori generali
favorite Package = Contenitore preferito
Board Cutout = Ritaglio della scheda
Surface Mount = Montaggio Superficiale
JLCPCB Part Class = Classe parte JLCPCB
base = base
expand = espandi
recommend = raccomandato
Basic Part = Parte semplice
Extended Part = Parte estesa
Recommended Part = Componente consigliato
smtWeld = Saldatura smt
thtWeld = Saldature tht
manualWeld = Saldatura manuale
furnaceWeld = Saldature tramite forno 
Multi-Layer = Multistrato
Markdown Syntax = Sintassi Markdown
Markdown supported = Markdown supportato
Read only = Sola lettura
Read/Write = Lettura/Scrittura
More Libraries... = Altre librerie...
Decompress failed! = Impossibile decomprimere!
Load failed! = Impossibile caricare
Loading = Caricamento
No Result = Nessun risultato

#Dialog Place Pin in schematic warning
Place Pin in schematic warning =
You can place a Pin in schematic, but don't forget to group all of the Pins to a schematic component, please click the help button to find out how to group them. If you just want to mark the wire, please use NetPort or NetNabel. = Puoi posizionare un pin nello schema, ma non dimenticarti di raggruppare tutti i pin nello schema del componente. Premi il pulsante help per scoprire come raggrupparli. Se vuoi semplicemente marcare il filo, usa NetPort o NetLabel.
I know. Do not show this again. = Lo so. Non mostrarmelo di nuovo.

#Extensions Setting
Extensions Setting = Impostazioni delle estensioni
Remove = Rimuovi
Disable = Disabilita
Enable = Abilita
(Disabled) = (Disabilitato)
(Enabled) = (Abilitato)
Load Extension = Carica estensione
Enable or disable will be applied after reload page = Abilita o disabilita verrà applicato dopo aver ricaricato la pagina
Your browser cannot run this function. = Il tuo browser non può eseguire questa funzione.
Your browser mode does not support indexedDB. Some features may not work properly. Are you using Private Browsing Mode? = La modalità del tuo browser non supporta indexedDB. Alcune funzioni potrebbero non funzionare correttamente. Stai utilizzando la modalità di navigazione in incognito?
Extension Files = File di estensione
Extension ID = ID dell'estensione
Select Files = Seleziona file

#Scripts
Script = Script
Scripts = Script
Script Content = Contenuto dello script
Load from js file = Carica da file js
UTF-8 encoded js file = File js con codifica UTF-8
Description = Descrizione
description = descrizione
Not a *.js file = Non è un file *.js
Failed to read file = Impossibile leggere il file
System scripts cannot be modified = Gli script di sistema non possono essere modificati
Create Subfolder = Crea sottocartella
Create Script = Crea script
Install Script = Installa script
Install = Installa
Are you sure you want to remove this script? = Sei sicuro di voler eliminare questo script?
Folder Name = Nome della cartella
Rename = Rinomina
Please select a script = Seleziona uno script
Failed to load script = Impossibile caricare lo script
Run Script = Avvia lo script
Load Script = Carica lo script
Title is required = Il titolo è obbligatorio
Script content is required = Il contenuto dello script è obbligatorio
System Scripts = Script di sistema
User Scripts = Script dell'utente
You can right click on the tree nodes. = Puoi fare clic con il pulsante destro del mouse sui nodi dell'albero.

#PCB photoView toolbar
Top Side = Lato superiore
Bottom Side = Lato inferiore
With Silk Layer = Con strato serigrafia
No Silk Layer = Senza strato serigrafia
Photo View = Vista 2D 

#check update
Check Update = Verifica Aggiornamenti
EasyEDA Editor {ver} is released. Would you like to switch to the new version now? = Una nuova versione di EasyEDA Editor {ver} é disponibile. Vuoi passare alla nuova versione ora?
LCEDA Editor {ver} is released. Would you like to switch to the new version now? = Una nuova versione di LCEDA Editor {ver} é disponibile. Vuoi passare alla nuova versione ora?
Switch to New Version = Passa alla nuova versione
Next Time = In seguito

#download project dialog
Generating download link... = Genera link per il download...
Download project now = Scarica adesso il progetto

#Import DXF
Import DXF = Importa DXF
Apply Unit = Applica unità
Convert circle to HOLE on BoardOutLine layer =
No shapes found = Non è stata trovata alcuna forma
Fail to load the file = Impossibile caricare il file.
Please select a DXF file. = Seleziona un file DXF.
This feature only works for PCB document. = Questa funzione è disponibile solo per il documento PCB.
Select a DXF file = Seleziona un file DXF

#Export DXF
Export DXF = Esporta DXF
Plated-Through-Hole Pads =
Non-Plated-Through-Hole Pads =
Silkscreen = Serigrafia
Surface Pad = Pad superficiale

#Data Sync
Data Sync = Sincronizzazione di dati
Data Conflicts = Conflitti di dati
Project or Document = Progetto o documento
Cloud-Side = Sul cloud
Local-Side = In locale
Decision = Decisione
Modified = Modificato
Deleted = Eliminato
As Cloud = Come cloud
As Local = Come locale
Skip = Ignora
Data sync completed = Sincronizzazione dei dati completata

#Team
Team = Gruppo
Teams = Gruppi
Switching team = Cambia gruppo
Switch team failed = Impossibile cambiare gruppo
Load team info fail! = Impossibile caricare le informazioni del gruppo!
Load team info fail! Please reload. = Impossibile caricare le info del gruppo! Ricarica.
My Teams = I miei gruppi
Create Team = Crea un gruppo

#Dialog Footprint Manager
Footprint Manager = Gestore footprint
Open Footprint Manager = Apri il gestore footprint
Schematic Components = Componenti dello schema
Edit Pin Map Information = Modifica la mappatura dei pin
Package Categories = Categorie dei contenitori
Components List = Elenco dei componenti
Personal = Personale
Component PIN information = Informazioni sul PIN del componente
Footprint PAD information = Informazioni sulla PAD del footprint
Footprint Categories = Categorie footprint
Pad Number = Numero pad
Search Footprint = Cerca footprint
Filter by keyword = Filtra per parola chiave
System Libs = Librerie di sistema

#dialog global delete
Drawings = Disegni
Netlabel and netFlag = Netlabel e netflag
Texts = Testi
Wires = Fili
Board outlines = Contorni della scheda
Footprints = Footprint
Footprint = Footprint
Tracks = Piste

#dialog board outline settings
Current Size = Dimensione attuale
Paramenters = Parametri
Start X: = Origine X:
Start Y: = Origine Y:
Round Rectangular = Rettangolo arrotondato
radius = Raggio
only number is allowed! = è consentito solo il numero!
please input valid value of width! = digita un valore valido per la larghezza!
please input valid value of height! = digita un valore valido per l'altezza!
please input valid value of radius! = digita un valore valido per il raggio!

#cross probe
The object you selected was not found in other documents. = Gli oggetti che hai selezionato non sono presenti in altri documenti.
No valid object for cross probe selected. = Nessun oggetto valido selezionato per il cross probe.
Can not probe. Refreshing the window may get it to work. = Non trovo l'oggetto. Aggiorna la finestra potrebbe risolvere il problema.
You need to login for this function to work. = Devi autenticarti per accedere a questa funzione.

#About Dialog
An Easier EDA Experience = Un'esperienza EDA più semplice
Version = Versione
BuiltDate = Data di rilascio

#Auto Router Dialog
Auto Router Config = Configurazione sbroglio automatico
General Options = Opzioni generali
All Layers = Tutti gli strati
Configure = Configura
Sorry, your web browser does not support this feature. Please run a modern browser. = Il tuo browser non supporta questa funzione. Utilizza un browser più moderno.
Please make sure all objects with net are inside the board outline! = Tutti gli oggetti con una net devono essere all'interno del contorno della scheda!
Cannot start again before previous activity is stopped = Impossibile ricominciare prima dell'interruzione dell'attività precedente
Please select a net = Seleziona una net
TrackWidth cannot be empty = La larghezza della pista non può essere vuota
Clearance cannot be empty = Isolamento non può essere vuoto
Router is time out. =
Server is busy, please try again later. = Il server è occupato, riprova più tardi.
Due to the limitation of {0}router server{1} resources, multiple routers executing concurrently are not supported, please try again later or do it manually :-) =
Track Width is invalid = Il valore della larghezza della pista non è valido
General Clearance is invalid = Il valore dell'isolamento generale non è valido
SMD Clearance is invalid = Il valore dell'isolamento SMD non è valido
Diameter is invalid = Il valore del diametro non è valido
Drill Diameter is invalid = Il valore del diametro del foro non è valido
Track width cannot be less than Design Rule Checking (DRC) setting value. = La larghezza della pista non può essere inferiore al valore di impostazione del Design Rule Checking (DRC).
General Clearance cannot be less than Design Rule Checking (DRC) setting value. = L'isolamento generale non può essere inferiore al valore di impostazione del Design Rule Checking (DRC).
SMD Clearance cannot be less than Design Rule Checking (DRC) setting value. = L'isolamento del SMD non può essere inferiore al valore di impostazione del Design Rule Checking (DRC).
Hole size cannot be less than Design Rule Checking (DRC) setting value. = La dimensione del foro non può essere inferiore al valore di impostazione del Design Rule Checking (DRC).
Design Rule's via diameter must be larger than via drill diameter =
Clearance cannot be less than Design Rule Checking (DRC) setting value. = L'isolamento non può avere un valore inferiore a quello dell'impostazione del Design Rule Checking (DRC).
Not a valid PCB, please check it again = Nessun PCB valido, controllalo di nuovo
Previous connection must be closed = La connessione precedente deve essere chiusa
Network error. Please try again. = Errore di rete. Riprova.
Router error. = Errore di sbroglio.
Invalid PCB. = PCB non valido.
General Clearance = Isolamento generale
SMD Clearance = Isolamento SMD
#Ripup Nets
Skip Routed Nets = Ignora Net sbrogliate
Remove Existing Tracks = Rimuovi piste esistenti
Real-time Display = Mostra processo in tempo reale
Router Layers = Layer da sbrogliare 
Via = Via
Special = Speciale
Special Nets = Net speciali
Skip Nets = Ignora net
Router Server = Server di sbroglio 
Local = Locale
Cloud = Cloud
Available = Disponibile
Unavailable = Non disponibile
Checking = Controllo
Install Local Auto Router = Installa lo sbroglio automatico locale
Checking local auto router server... = Controlla il server dello sbroglio automatico locale...
Stop Router = Ferma sbroglio
Auto Router is running... = Auto-Sbroglio in corso...

#Left Siderbar
EELib = EELib
Basic = Di base
Extend = Estendi
Design Manager = Gestore del design
Library = Libreria
Spice Library = Libreria Spice
Shared = Condivisi
LCSC = LCSC
LCSC Parts = Componenti LCSC
Supply Flag = Indicatore di alimentazione
US = US
EU/IEC = EU/IEC
US Style = Stile US
Resistor = Resistore
Capacitor = Condensatore
Inductor = Induttore
Switch/Key = Interruttore/Pulsante
EU/IEC Style = Stile EU/IEC
CN = CN
Connector = Connettore
Switch/Relay = Interruttore/Relè
JLCPCB = JLCPCB
Recycle Bin = Cestino

# Protractor
Font Height = Altezza del carattere
Precision = Precisione
Protractor = Goniometro

#attr-pcbtext-line-width
Only default font family supports to change font width. = Solo la famiglia di caratteri predefinita supporta la modifica della larghezza del carattere.
Font is missing! You can confirm the dialog and use default font instead or cancel the dialog then upload your font and do it again. = Font mancante! Conferma per usare il font di default o cancella per caricare il nuovo font e riprovare.

#Common
Owner = Proprietario
License = Licenza
Part Pins = 
Net Pins =
Net Ratlines =
Add Parameter = Aggiungi parametro
Histories record = Cronologia dei dati
Create Team = Crea gruppo
Can't find this footprint on the server, please re-associate it. = Impossibile trovare questo footprint sul server, associalo di nuovo.
The footprint name associated with the component and the footprint name on the server are inconsistent, please re-associate it. = Il nome del footprint associato al componente e il nome del footprint presente sul server non sono coerenti, associalo di nuovo.
The symbol pin number(s) of the component does not match the associated footprint pad number(s), please modify the symbol pin number(s) or re-associate the footprint = Il numero dei pin del simbolo del componente non corrisponde al numero del pad del footprint associato, modifica il numero dei pin del simbolo oppure riassocia il footprint
No footprint, please associate the footprint first. = Nessun footprint, prima devi associare il footprint.
Can't find the package = Impossibile trovare il contenitore
The path is for the project URL identify, it is unique (the identity of the project owned by the user cannot be the same) = Il percorso è per l'identificativo dell'URL del progetto, è univoco (l'identità del progetto di proprietà dell'utente non può essere la stessa)
It's with a letter or a number and can contain only numbers, letters, line-through, underscores, and points. It cannot be modified after saving. = È con una lettera o un numero e può contenere solo numeri, lettere, linee, trattini bassi e punti. Non può essere più modificato, dopo che è stato salvato.
Updating document to new format, please wait......After finishing please save your document with Ctrl + S. = Aggiornamento del documento in un nuovo formato, attendere prego... Al termine, salva il documento con Ctrl + S.
Open at current project? =
Please select a history to recover. =
Be careful! When you click the "Recover" button, this sheet will be overwritten! = Stai attento! Quando fai clic sul pulsante "Ripristina", questo foglio verrà sovrascritto!
Recover = Recupera
There is no PCB under this project, would you like to create one? = Non c'è nessun PCB in questo progetto, vuoi creane uno?
Please make sure that the chose Altium Designer files are saved as ASCII files. = Assicurati che il file Altium sia salvato in ASCII.
Export to Altium function is currently in beta: = La funzione esporta in Altium è attualmente in versione beta:
1. Please be sure to read the notice before exporting: = 1. Assicurati di leggere l'avviso prima di esportare:
Export Altium notice and disclaimer =
2. Please be sure to check again after export! = 2. Assicurati di ricontrollare dopo l'esportazione!
I have read and agree = Ho letto ed accetto
Export to Altium = Esporta in Altium
Please make sure that the chose Eagle files are saved in Eagle v6.0 and above. = Assicurati che i file Eagle siano salvati con Eagle v6.0 o superiore.
Please make sure that the Kicad files were compressed as the .zip file. = Assicurati che i file di Kicad siano compressi in file formato .zip
Open Altium Designer file = Apri Altium Designer file
The more information please refer at : = Per maggiori informazioni fai riferimento a :
Please use Gerber file instead of exporting Altium if you are going to do PCB manufacturing. All PCB factories support the Gerber file. Is it ok to Generate the Gerber file? = Se vuoi mandare in produzione un PCB, utilizza il file Gerber invece di esportare un file Altium. Tutte le fabbriche di PCB supportano i file Gerber. Vuoi generare i file Gerber? 
Yes, Generate Gerber = Sì, genera Gerber
No, Export Altium = No, Esporta Altium
Open Eagle file = Apri file di Eagle
Open Kicad file = Apri file di Kicad
Select file(s) = Seleziona file
Append to current project? = Aggiungi al progetto attuale?
Append = Aggiungi
Open as new project = Apri come nuovo progetto
Tip: Press {0}SPACE{1} or {2}R{3} to rotate the placing object or selected object. = Suggerimento: premi {0}SPACE{1} o {2}R{3} per ruotare l'oggetto da inserire o l'oggetto selezionato.
Hotkeys Setting = Impostazione dei tasti di scelta rapida
I know. Don't show this again. = Lo so. Non mostrarmelo di nuovo.
Manufacturer Part Number can not be less than 2 characters. =
This prefix was changed to non-subpart format. = Questo prefisso è stato modificato in formato non sotto-parte.
Save as New Project = Salva come nuovo progetto
Save to Existing Project = Salva come progetto esistente
Sheet Setting = Impostazione del foglio
Sheet Size = Dimensione del foglio
Pre =
pre =
Invalid Data = I dati non sono validi
Others = Altri
You are not authorized to share this project. = Non sei autorizzato a condividere questo progetto.
This project is private: if you continue sharing it will be made public. = Questo progetto è privato: se lo condividi diventerà pubblico.
Modify file info = Modifica le informazioni del file
Please input search keyword = Inserisci la parola chiave nella ricerca
Sort Projects by = Ordina i progetti per
Date Created = Data di creazione
Date Modified = Data di ultima modifica
Title = Titolo
Ascending = Ascendente
Descending = Discendente
Pin to Top = Blocca in cima
Unpin from Top = Sblocca dalla cima
Collapse / Expand = Comprimi / Espandi
Expand = Espandi
Collapse = Comprimi
Expand All = Espandi tutto
Collapse All = Comprimi tutto
Your file hasn't been saved, do you want to save it? = Il file non è stato salvato, vuoi salvarlo?
Don't Save = Non salvare
Library Owner: = Proprietario della libreria:
verifyPkg.Value = verify.Pkg.Valore
State = Stato
Please select! = Per favore seleziona!
Route = Sbroglio
Import successfully: = Importato con successo:
Import failed: = Impossibile importare:
The title length must be between 2~128 characters. = La lunghezza del titolo deve essere compresa tra 2 e 128 caratteri.
Path only contain 'a-z、A-Z、- 、 _ 、0-9'! = Il percorso contiene solo 'a-z、A-Z、- 、 _ 、0-9'!
Path must begin as 'a-z、A-Z、0-9'! = Il percorso deve iniziare per 'a-z、A-Z、0-9'!
The path length must be between 4~128 characters! = La lunghezza del percorso deve essere compresa tra 4 e 128 caratteri!
The title length must be between 2~256 characters! = La lunghezza del titolo deve essere compresa tra 2 e 256 caratteri!
The title cannot be less than 3 characters! = Il titolo non può essere inferiore a 3 caratteri!
Do you want to delete this file? = Vuoi eliminare questo file?
Add sub part success = Sotto-parte aggiunta con successo
Please input name and prefix! = Inserisci nome e prefisso!
Board outlines are not closed = Il contorno della scheda non è chiuso
Import Altium file fail, the file needs to be an ASCII file encoded in UTF-8. = Impossibile importare il file Altium, deve essere un file ASCII codificato in UTF-8.
The Pins "{0}" are not snapped on the grid point! This part maybe will cause some errors in the schematic. = I Pin "{0}" non sono agganciati al punto della griglia! Questo componente potrebbe causare alcuni errori nello schema.
Check Pin = Controlla pin
Failed to read {0} = Impossibile leggere {0}
{0} is invalid = {0} non è valido
{0} not found = {0} non è stato trovato
Failed to execute script: = Impossibile eseguire lo script:
One or more js files not found = Uno o più file js non sono stati trovati
Only ONE {0} file is required = Solo UN {0} file è richiesto
Extension ID is required = L'ID dell'estensione è obbligatoria
Extension ID is invalid = L'ID dell'estensione è errata
Extension ID is duplicated = L'ID dell'estensione è duplicata
No Result! = Nessun risultato!
Load Error = Si è verificato un errore durante il caricamento
loading = caricamento
Failed to load spice data = Impossibile caricare i dati spice
Netlist = Netlist
Tags = Tag
Pin Information: = Informazione del pin:
Format incorrect, please check for the extra spaces or commas! =
Round Radius =
Keyword: = Parola chiave:
Image = Immagine
Image copied. = L'immagine è stata copiata.
Copy failed. = Impossibile copiare.
Copy success. = Copia completata.
Image Property = Proprietà dell'immagine
Locked = Bloccato
Unlock All = Sblocca tutto
Unlock = Sblocca
Lock = Blocca
Please input pin name and pin number! = Inserisci il nome ed il numero del pin!
Left-Hand Panel = Pannello a sinistra
Right-Hand Panel = Pannello a destra
Update All = Aggiorna tutto
The pin number(s) can't find the same pad number(s) = Il numero dei pin non corrisponde al numero dei pad
Designator = Designatore
Replace = Sostituisci
Update failed = Aggiornamento non riuscito
Successfully updated = Aggiornamento riuscito con successo
Update failed! = Aggiornamento non riuscito!
Successfully updated! = Aggiornamento riuscito con successo!
Successfully updated {0} component(s)! = Sono stati aggiornati {0} componenti!
Change = Modifica
Check Footprints = Controlla Footprint
Network Error! = Errore di rete!
Find Similar Objects = Trova oggetti simili
Current Sheet = Foglio attuale
All Sheets = Tutti i fogli
Kind = Genere
Range = Gamma
Net Label/Net Flag/Net Port/Voltage Probe =
Bezier/Freehand Draw =
Arc/Pie = Arco/Torta
Objects Properties = Proprietà degli oggetti
Any = Qualsiasi 
Same = Uguale
Different = Differente
Circular = Cerchio
Expose Copper = Esponi rame
"{0}" font is missing. Please add the font to the font family list. =
Place Component = Posiziona il componente
Delete Segment = Elimina segmento
Angle = Angolo
Board Thickness = Spessore scheda 
Layer Distance = Distanza tra gli strati
Silk Screen = Serigrafia
Surface Finish Color = Colore aree esposte
Colors = Colori
Board Color = Colore scheda
Board Side = Lato scheda
Silk Screen = Serigrafia
Silk Screen Color = Colore serigrafia
Display = Visualizza

# Array and Clone
Distribute Array = Distribuisci selezione
Array Type = Tipo di distribuzione
Matrix Array = Matrice 
Circular Array = Circolare
Item Rotation = Rotazione dell'oggetto
Location = Posizione
Items per Column = Oggetti per colonna
Items per Row = Oggetti per riga
# Column Spacing
# Row Spacing
Spacing(Degrees) = Spaziatura (gradi) 
Start Degree = Angolo iniziale 
Rotate Item to Match = Ruota elementi
Clockwise = Senso orario
Anti-Clockwise = Senso antiorario
Distribute by = Distribuisci su
Column = Colonna
Row = Riga
Array Clone = Duplica selezione
Number of Rows = Numero di righe
Number of Columns = Numero di colonne
Number of Copies = Numero di copie
Distribute Range(Degrees) = Angolo di distribuzione (gradi)

# Theme color dialog
BusEntry = BusEntry
Foreground = Primo piano
Common Used = Uso comune
Original Theme = Tema originale
Theme Setting = Impostazione del tema
Change the theme colors of your design = Modifica i colori del tema del tuo disegno
White on Black = Bianco su nero
Black on White = Nero su bianco
Custom Theme = Tema personalizzato
Color Setting = Impostazione del colore
Apply Setting = Applica impostazione
Theme Setting... = Impostazione del tema...
Bus Entry = Bus entry
Foreground = Primo piano
Symbol Graphics = Grafica dei simboli
Common Used = Uso comune
Draw = Disegno
Sheet = Foglio
The original theme only works for placing the new symbols. =
Selection Highlight = Evidenzia la selezione
Net Label / Port = Net label / Porta

My Theme = Il mio tema
My Theme Settings = Le impostazioni del mio tema
Apply 'Custom Theme' On = Applica 'tema personalizzato' su
Creating New Schematic = Creazione di un nuovo schema
Opening Existed Schematic = Apertura dello schema esistente
Please fill in all parameters! = Inserisci tutti i parametri!
Convert to Board Cutout = Converti in ritaglio bordo
Prefix Position = Posizione del prefisso
Name Position = Posizione del nome
Center = Centro
Top = Superiore
Bottom = Inferiore
Left = Sinistra
Right = Destra
Does not support multiple objects to convert to Board Cutout at the same time =
Does not support multiple objects to convert to pad at the same time =
Convert to Board Cutout = Converti in ritaglio bordo
Convert to Pad = Converti in Pad
Convert to Component Shape = Converti in forma componente
Combine to Continuous Track = Combina in pista continua
Convert to Solid Region = Converti in regione solida
Substrate = Substrato
3D View = Vista 3D
2D View = Vista 2D
Pin Color = Colore del pin
Name Color = Colore nel nome
Number Color = Colore del numero
Dot = Punto

[theme]
Sheet = Foglio
[/theme]


#history dialog
[history-dlg]
Number = ID
Editor = Utente
[/history-dlg]
View File History = Salvataggi passati
Save Time = Timestamp

Invalid Format = Il formato non è valido

#Dialog Teardrop
Round Pad / Via = Pad arrotondato / Via 
Rectangle / Oval / Polygon Pad = Rettangolo / Ovale / Pad da poligono
Applying Teardrops = Creazione teardrop
Removing Teardrops = Cancellazione teardrop
Waiting = In attesa
Progressing... = Elaborazione...

No schematic in the project! = Nessuno schema nel progetto

Move Forward = Sposta avanti
Move Backward = Sposta indietro

#Dialog Panelize
V-CUT = V-CUT
Stamp Hole =
No Panelize = Non pannellizzare 
Border and Marking = 
Create Border = Crea Bordo
Border Height = Altezza bordo
Border Position = Posizione bordo
Create Positioning Holes =
Create Fiducial Marks = Crea Fiducial Mark
Top and Bottom = Sopra e sotto
Left and Right = Sinistra e destra
Stamp Hole Group - Column =
Stamp Hole Group - Row =
The number of rows and columns cannot be set to 1 simultaneously = Il numero di righe e di colonne non può essere impostato contemporaneamente su 1

#edit path point
[editPathPoints-dlg]
Arc(R) = Arco(R)
Type = Tipo
Action = Azione
add before = aggiungi prima
add after = aggiungi dopo
delete = elimina
[/editPathPoints-dlg]

#edit polygon point
[editPolygonPoints-dlg]
Action = Azione
add before = aggiungi prima
add after = aggiungi dopo
delete = elimina
[/editPolygonPoints-dlg]
You have unconfirmed edit! = Hai una modifica non confermata!
Invalid edit! = Modifica non valida!

#Dialog PCB Information
PCB Information... = Informazioni PCB...
Signal Layers = Strati del segnale
None Signal Layers = Strati senza segnale
Pads = Pad
Surface Pads = Pad superficiali
Plated Through-hole Pads = Pad placcati con foro passante
None Plated Through-hole Pads = Pad non placcati con foro passante
Holes = Fori
Vias = Via
Length of Tracks = Lunghezza delle piste
Copper Areas = Zone di rame

#Differential Pair Routing
Differential Pair Routing = Sbroglio delle coppie differenziali
Differential Pair Rule Setting = Impostazioni sbroglio delle coppie differenziali
Please input track width = Inserisci la larghezza della pista
Please input clearance = Inserisci lo spazio tra le tracce
Routing Rules = Regole dello sbroglio

#Route Length Tuning
Track Length Tuning... = Regolazione della lunghezza della pista...
Tracks with different net or non-track found in current targets. =
Please select the signal tracks to be tuning. = Selezionare le piste del segnale da regolare.
The total length exceeds the Design Rule Checking (DRC) constraint, continue ? = La lunghezza totale supera il vincolo del Design Rule Checking (DRC), continuare ?
45° Angle = Angolo di 45°
90° Angle = Angolo di 90°
DRC Track Length : = Lunghezza della pista DRC :
Current Length : = Lunghezza attuale :
Additional Length : = Lunghezza aggiuntiva :
Target Length: = Lunghezza dell'oggetto:
Current Length: = Lunghezza attuale:

can not connect to the server = impossibile connettersi con il server

#Dialog Copper Area Manager
Copper Area Manager... = Gestisci zone di rame...
Copper Area Manager = Gestisci zone di rame
Order = Ordine
Name = Nome
Layer = Strato
Color = Colore
Net = Net
Move Up = Sposta sopra
Move Down = Sposta sotto
Apply = Applica
Cancel = Annulla
Copper Area do not allow self-intersection! = La zona di rame non consente l'autointersezione!
No copper area! = Nessuna zona di rame!
#Dialog report error
Datasheet = Datasheet
Verification = Verifica
Symbol = Simbolo
Pad Number = Numero pad
Pad Size = Dimensione pad
Remark = Nota
Correct = Corretto
Incorrect = Errato
Submit = Invia
Tip = Suggerimento
Please select one component = Seleziona un componente
Location X = Posizione X
Location Y = Posizione Y
Your current browser version may not support some features. Please use the latest version of Chrome or Firefox, or try the desktop client. = La versione attuale del tuo browser potrebbe non supportare alcune funzionalità. Utilizza l'ultima versione di Chrome o Firefox oppure prova il client desktop.
EasyEDA Client = Client EasyEDA
LCEDA Client = Client LCEDA
Chrome = Chrome
FireFox = FireFox
New Version = Nuova versione
Switch Version = Cambia versione
Members = Membri
Update Time = Tempo di aggiornamento
Editor = Editor
Current Version: = Versione attuale:
Select a version to switch = Seleziona una versione
3D Model = Modello 3D
Board Side = Lato bordo
Display = Visualizza
Copper = Rame
Create New Version = Crea una nuova versione
Create new version success! = Nuova versione creata con successo!
Version Management = Gestione della versione
Switch success! = Cambio eseguito con successo!
Please close current version's documents first! = Chiudi prima i documenti della versione attuale!
Creator = Autore
Create Time = Tempo creazione
Fail to connect to server! Please check your internet connection status and try again! = Impossibile connettersi al server! Controlla la tua connessione ad internet e prova di nuovo!
Spice Number = Numero spice
Create = Crea
3D Outline = Contorno 3D
Cannot create the slot hole via the board outline, please use the following methods: = Impossibile creare il foro dello slot tramite il contorno della scheda, utilizzare i seguenti metodi:
Use the solid region and set its type as Board Cutout = Usa la regione solida e imposta il suo tipo come Board Cutout
Select a Track/Arc, right-click to use the "Convert to Board Cutout" = Seleziona una pista/arco, fai clic con il pulsante destro del mouse per utilizzare "Converti in ritaglio bordo"
Select all the closed Tracks/Arcs, right-click to use the "Convert to Board Cutout" = Seleziona tutte le piste/archi chiusi, fai clic con il pulsante destro del mouse per utilizzare "Converti in ritaglio bordo"
The more information please refer at = Per maggiori informazioni fai riferimento a
Save "{0}" success! = "{0}" salvato con successo!
Save "{0}" failed! = Impossibile salvare "{0}"!
Invalid Size = Dimensione errata
Processing = In lavorazione
Invalid Size = Dimensione errata
NetFlag GND = NetFlag GND
NetFlag VCC = NetFlag VCC
NetFlag +5v = NetFlag +5v
No Useful Data! = Nessun dato utile!
SVG Preview = Anteprima SVG
Prefix contains not supported charater(s) ! = Il prefisso contiene caratteri non supportati!
Name contains not supported charater(s) ! = Il nome contiene caratteri non supportati!
Create Grid Path = Crea il percorso della griglia
Please Input Name = Inserisci il nome
Building Copper Area = Costruzione della zona di rame
Processing = In lavorazione
Opening File = Apertura del file
Update from Library = Aggiorna dalla libreria
Update Footprint = Aggiorna footprint
Find footprint(s) have been updated, do you want to update? =
3D File: = File 3D:
Model List = Lista dei modelli
Are you sure merge net {0} and net {1}? = Sei sicuro di voler unire la net {0} con la net {1}?
Display Footprint = Mostra footprint
Display Footprint Name While Placing Component = Mostra il nome del footprint mentre posizioni il componente
Annotate Prefix Automatically After Placing Component = Annota automaticamente il prefisso dopo aver posizionato il componente
Program Error, Please Contact Technical Support! = Errore del programma, contattare il supporto tecnico!
Search Engine = Motore di ricerca
Keyword to Filter = Parola chiave da filtrare
Normal Mode = Modalità normale
Expand Mode = Modalità di espansione
3D Model Manager = Gestisci modello 3D
3D Model Preview = Anteprima modello 3D
3D Model = Modello 3D
3DModel = Modello3D
Document = Documento

[pcblayer]
3DModel = Modello3D
Document = Documento
[/pcblayer]

Adjustment = Regolazione
View Larger Image = Visualizza immagine più grande
Previous = Precedente
Previous Image = Immagine precedente
Next Image = Immagine successiva
Notice: For reference only, please refer to the real product = Avviso: fare riferimento al prodotto reale
It's under designing, please wait. = È in fase di progettazione, attendi.
The width of track/arc/circle cannot be less than 0.1mil! = La larghezza della pista/arco/cerchio non può essere inferiore a 0,1 mil!
Clone success ! = Duplicato con successo!
Footprint Naming Reference = Riferimento per la denominazione del Footprint
3D Model Manager = Gestisci modello 3D
Will jump to the Lichuang open source hardware platform (OSHWHub.com) to improve the information and share. Whether to continue? = Si passerà alla piattaforma hardware open source Lichuang (OSHWHub.com) per migliorare le informazioni e condividerle. Continuare?
Will jump to the EasyEDA open source hardware platform (OSHWLab.com) to improve the information and share. Whether to continue? = Si passerà alla piattaforma hardware open source EasyEDA (OSHWLab.com) per migliorare le informazioni e condividerle. Continuare?
The project content page will open. After adding a description and setting the project to public, you can click the share button to get the share link. = Si aprirà la pagina del contenuto del progetto. Dopo aver aggiunto una descrizione e aver impostato il progetto come pubblico, puoi fare clic sul pulsante di condivisione per ottenere il link di condivisione.
This project is not public, can not view homepage! = Questo progetto non è pubblico, non è possibile visualizzare la homepage!

[grid]
None = Nessuno
[/grid]

#lib verify and mounted
This component is verified = Questo componente è verificato
This component is unmounted = Questo componente è smontato

#find component
Find Next = Trova successivo
Object not found = Componente non trovato

#offset Elements
Offset X = Offset X
Offset Y = Offset Y
Offset = Offset
Absolute Offset = Offset assoluto
Relative Offset = Offset relativo
Absolute Offset... = Offset assoluto...
Relative Offset... = Offset relativo...
Reference Point X = Punto di riferimento X
Reference Point Y = Punto di riferimento Y

# Inner Plane layer
Rebuild Plane = Ricrea piano
PlaneZone Properties =
Change to a plane layer is not allowed during track routing. =
#pcblib rect
Fill = Riempi
Fill Type = Tipo di riempimento
[PlaneZone]
Solid = Solido
[/PlaneZone]

Solid Region do not allow self-intersection! = Una regione solida non può auto-intersecarsi!

The prefix or name or text too far away from the footprint, if you don't want it to show up please make it hidden. = Il prefisso, il nome o il testo è troppo lontano dal footprint, se non vuoi che venga visualizzato, nascondilo.
The prefixes are not allowed to repeat! = I prefissi non possono essere ripetuti!
Save failed! The origin of the canvas is not in the graphics! Whether to set the origin automatically? = Impossibile salvare! L'origine di canvas non è nella grafica! Vuoi impostare l'origine automaticamente?
The origin of the canvas has been set in the graphics now, you can save again. = Adesso l'origine di canvas è stata impostata nella grafica, puoi salvare di nuovo.
Backup Project = Backup progetto
Open Project Directory = Apri la cartella del progetto

{0} items updated = {0} oggetti aggiornati

The current file {0} has an updated version. Do you want to overwrite it? If you want to open the latest version, please close the current file and reopen it. = Il file attuale {0} ha una versione aggiornata. Vuoi sovrascriverlo? Se vuoi aprire l'ultima versione, chiudilo e riaprilo.
Yes, Overwrite It = Sì, sovrascrivilo
No, Keep It = No, lascialo così

Download Client = Scarica client

Search tutorial、open source projects etc. = Cerca tutorial, progetti open source ecc.

Go to LCSC and search for = Vai su LCSC e cerca
Go to LCSC = Vai su LCSC

Hide Ratline Layer and Keep the Component Prefix When Paste Objects =

ALL.layer =
Copper.layer =
Non-Copper.layer =
Other.layer =

Please enter at least 2 characters! = Digita almeno 2 caratteri!
View Datasheet = Mostra datasheet
View Datasheet... = Mostra datasheet...

The corresponding package or network could not be found in the currently open PCB document =
delete fail = Eliminazione fallita

[crashRecovery]
Libraries = Librerie
[/crashRecovery]
Canvas origin anomaly! = Anomalia dell'origine canvas!

Component's Name = Nome del componente
Component's Prefix = Prefisso del componente
Component's Footprint = Footprint del componente

[findlib]
Clear = Cancella
Apply Filters = Applica filtri
Result = Risultato
Place = Posiziona
Prev = Precedente
Next = Successivo
Total {count} Count = Conteggio totale {count}
About = Informazioni
Items = Oggetti
[/findlib]

Object = Oggetto
Layers and Objects = Strati e oggetti
All = Tutto

Add custom = Aggiungi personalizzato

Connections = Connessioni
Attempted: = Tentativi:
Completed: = Completati:
Failed: = Falliti:
Total Vias: = Via totali:

Please confirm moving option = Conferma l'opzione di spostamento
Only this pad = Solo questo pad
For this component = Per questo componente
View Owner = Mostra proprietario
View Detail = Mostra dettaglio


# place batch vias
Place Vias = Posiziona via
Placing Vias = Posiziona via
Removing Vias = Rimuovi via
Batch Vias for Copper =
Add/Remove Vias = Aggiungi/Rimuovi via
Diameter = Diametro
Drill Diameter = Diametro del foro
Column Spacing = Spaziatura tra le colonne
Row Spacing = Spaziatura tra le righe
Multiple vias have been placed, do you want to rebuild the copper area? = Sono state inserite delle via, vuoi rigenerare la zona di rame?
Remove vias finish, do you want to rebuild the copper area? = Rimozione via completata, vuoi rigenerare la zona di rame?
The width of track/arc/circle cannot be less than 0.051mm/2mil/0.002inch! = La larghezza della pista/arco/cerchio non può essere inferiore a 0.051mm/2mil/0.002pollici!
Save fail! Please try again! = Impossibile salvare! Riprova!
Please select a copper outline =
Can't find copper area at other layers, please add the copper area with the same net at other layer first. = Impossibile trovare la zona di rame sugli altri strati, aggiungere prima la zona di rame con la stessa net sull'altro strato.

Add favorite success! = Aggiungi ai preferiti
Remove favorite success! = Rimosso dai preferiti!
Remove favorite failed! = Impossibile rimuovere dai preferiti
Whether if remove favorite? = Rimuovere dai preferiti?
Split by ';' for multi tags = Diviso da ';' per tag multipli

This size is the determined size! = Questa è la dimensione determinata!
The associated pad has been locked = Il pad associato è stato bloccato!
Split by space or , for multi tags = Diviso da spazio oppure , per tag multipli

Rotation X = Rotazione X
Rotation Y = Rotazione Y
Rotation Z = Rotazione Z

Some fields are filled invalid data = Alcuni campi contengono dei dati errati
start time should be earlier than stop time = l'ora di inizio dovrebbe essere antecedente all'ora di fine
Number of points should be less than 100 in octave variation = Il numero di punti deve essere inferiore a 100 nella variazione di ottava
Start frequency should be less than stop frequency. The suffix meg stands for Mega,m stands for milli = La frequenza di avvio deve essere inferiore alla frequenza di arresto. Il suffisso meg sta per Mega, m sta per milli
Get historical records fail! = Impossibile recuperare i salvataggi passati!
This 3D model didn't create the outlines successfully, please import it again or contact with us. = Questo modello 3D non ha creato correttamente i contorni, importalo di nuovo oppure contattaci.
There is No Tag! = Non c'è nessun tag!
Assign successful! = Assegnazione riuscita!
Found footprint's pad number doesn't match the schematic component's pin number, please correct the pad number and try again! = Il numero del pad del footprint trovato non corrisponde al numero del pin del componente dello schema, correggi il numero del pad e riprova!
Update Property = Aggiorna attributi
Please fill in at least 5 words. = Inserisci almeno 5 parole
Mouse hovering over the track to highlight the entire network = Passa il mouse sulla pista per evidenziare l'intera rete
Net Highlighting While Cursor Hover the Track = Evidenzia la net mentre il cursore del mouse passa sulla pista
When circle set as "Yes", the Pin length must be more than 6 = Quando il cerchio è impostato su "Sì", la lunghezza del pin deve essere maggiore di 6
Hi, I found a problem of your library, this library seems incorrect.\ntitle:{title}\nType:{type}\nlink:{link}\n{content}\nThank you! = Ciao, ho riscontrato un problema con la tua libreria, questa libreria sembra errata.\ntitle:{title}\nType:{type}\nlink:{link}\n{content}\nGrazie!

Logout fail! Please try again! = Uscita fallita! Prova di nuovo!
Logout success! We look forward you to use LCEDA again! = Uscita effettuata! Speriamo che tu possa usare di nuovo LCEDA!
Logout success! We look forward you to use EasyEDA again! = Uscita effettuata! Speriamo che tu possa usare di nuovo EasyEDA!
Click to Preview 3D = Clicca per l'anteprima 3D
[logoutDialog]
Logout = Esci
[/logoutDialog]

[findlibTag]
All = Tutti
[/findlibTag]

Export Pick and Place File = Esporta file Pick and Place
Mirror the bottom component's X coordinate (JLCPCB doesn't need) = Specchia sull'asse X i componenti sullo strato inferiore (JLCPCB non richiede questa opzione)
Work Space = Area di lavoro
Include panelized components' coordinates = Includi le coordinate dei componenti pannellati
Personal Workspace = Area di lavoro personale
Work Space - {name} = Area di lavoro - {name}
Work Space - Personal = Area di lavoro - personale
Cloning = Duplicazione

Project Owner = Proprietario del progetto
Clone Project = Duplica il progetto
Homepage = Homepage
Apply for Education Edition = Candidati per l'edizione Education
Load Organization failed = Impossibile caricare l'organizzazione
Joined = Collaborazioni
Favorite = Preferiti
This operation will unfavorite this project, do you want to continue? =
View Homepage = Vedi la homepage
Private Project = Progetto privato
3-7 days = 3-7 giorni
Close Tab = Chiudi tab
Close Other Tabs = Chiudi gli altri tab
Close All Tabs = Chiudi tutti i tab
Open in New Window = Apri in una nuova finestra
Cursor Snap to Component's Origin or Pad Center While Dragging Component = Aggancia il cursore all'origine o al centro del componente quando trascinato
Undefined = Non definito
Input = Ingresso
Model Unit = Unità del modello
File Unit = Unità del file
This part contains subparts, please make sure you have checked other subparts before reporting error, do you want to continue? = Questa parte contiene sotto-parti, assicurarsi di aver controllato le sotto-parti prima di segnalare un errore, vuoi continuare? 

[saveAs]
Power = Alimentazione
[/saveAs]

Assign LCSC Part# = Assegna componente# LCSC
Unexpected error while converting. Perhaps unsupported file type or program bug. = Si è verificato un errore durante la conversione. Forse il tipo di file non è supportato oppure è un bug del programma.
Found duplicated component IDs, please click "OK" to re-assign component ID automatically, and then save the document and try again. = Sono stati rilevati dei duplicati tra gli ID dei componenti, fare clic su "OK" per riassegnare automaticamente l'ID dei componenti, quindi salvare il documento e riprovare.

#electromagneticSimulation
Electromagnetic Simulation... = Simulazione elettromagnetica...
You will upload Gerber to SuperEM for electromagnetic simulation (only upload Gerber, not including account data), do you want to continue? = Saranno caricati i file Gerber su SuperEM per la simulazione elettromagnetica (carica solo i file Gerber, esclusi i dati dell'account), vuoi continuare?
SuperEM is a 3-D full-wave electromagnetic simulation and design platform for high-speed PCB circuits and antennas, which is developed by Faraday Dynamics, Ltd. = SuperEM è una piattaforma di progettazione e simulazione elettromagnetica ad onda intera 3-D per circuiti PCB e antenne ad alta velocità, sviluppata da Faraday Dynamics, Ltd.
Visit the SuperEM = Visita SuperEM
SuperEM User Guide = Guida per l'utente di SuperEM
Upload Gerber to SuperEM successfully, please click "OK" buttun to continue = Caricamento dei file Gerber su SuperEM completato, clicca sul pulsante "OK" per continuare

Format = Disponi
View = Visualizza
Design = Design
Simulation = Simulazione
Advanced = Avanzate
Fabrication = Fabbricazione
Check DRC = Controlla DRC
Simulation Setting = Impostazione della simulazione
BOM = BOM
PCB Fabrication File(Gerber) = File di fabbricazione PCB(Gerber)
Pick and Place File = File Pick and Place
Parts Order = Ordina componenti
PCB Order = Ordina PCB
SIM = SIM
STD = STD
WaveForm = Forma d'onda

Place Module = Posiziona modulo
Please enter identification letters: = Digita le lettere di identificazione:
Only support English letters, up to 5. = Sono supportate solo lettere inglesi, fino ad un massimo di 5.

Exist doesn't annotate prefix component(s) in the module, please edit and annotate the unique prefix(s) for component(s) first. =
Opening = Apertura

Also update track's net (Only applies to circumstance under which prefix/netlabel changes and no component/wire is added or removed) = Aggiorna anche la net della pista (si applica solo nelle circostanze in cui il prefisso/netlabel cambia e nessun componente/filo viene aggiunto o rimosso)

# desktop client error feedback
Cannot open online documents on Project Offline mode. = Impossibile aprire documenti online in modalità progetto offline.

Please select a project = Seleziona un progetto
Opened Projects = Progetti aperti
Open Project = Apri progetto
Close Project = Chiudi il progetto
Open All Projects = Apri tutti i progetti
Close All Projects = Chiudi tutti i progetti
Select Owner = Seleziona il proprietario
Select Folder = Seleziona la cartella
Select Owner or Folder = Seleziona il proprietario o la cartella
Select Project = Seleziona il progetto
Folder = Cartella
New Folder = Nuova cartella
New Sub Folder = Nuova sottocartella
Delete Folder = Elimina la cartella
Move Project = Sposta il progetto
Move Folder = Sposta la cartella
# Rename Folder = # Rinomina la cartella
Please input the folder name = Inserisci il nome della cartella
Invalid folder name = Il nome della cartella non è corretto
Are you sure to delete this folder? = Sei sicuro di voler eliminare questa cartella?
All projects in this folder will be moved to the root directory. = Tutti i progetti in questa cartella saranno spostati nella cartella principale.
Create new folder successfully = E' stata creata una nuova cartella
Failed to create new folder = Impossibile creare una nuova cartella
Delete folder successfully = La cartella è stata eliminata
Failed to delete folder = Impossibile eliminare la cartella
Rename folder successfully = La cartella è stata rinominata
Failed to rename folder = Impossibile rinominare la cartella
Move folder successfully = La cartella è stata spostata
Failed to move folder = Impossibile spostare la cartella
Move project successfully = Il progetto è stato spostato
Failed to move project = Impossibile spostare il progetto
The folder depth must not exceed {0} levels = La profondità della cartella non deve superare i {0} livelli
Failed to add project to folder = Impossibile aggiungere il progetto nella cartella

Doesn't support JLCPCB SMT Service = Non supporta il servizio SMT di JLCPCB
{0} for JLCPCB SMT Service = {0} per il servizio SMT di JLCPCB

Reset failed! There are duplicate component prefixes in the current schematic: = Reset fallito! Ci sono prefissi duplicati nello schema corrente:
Reset failed! There are duplicate component prefixes in the current PCB: = Reset fallito! Ci sono prefissi duplicati nel PCB corrente:
Please modify the component prefixes first to ensure that the component prefix is unique. = Modifica prima i prefissi del componente e assicurati che il prefisso del componente sia univoco.

LCEDA(Standard) - A Simple and Powerful Electronic Circuit Design Tool = LCEDA(Standard) - Un semplice e potente strumento di progettazione circuitale
EasyEDA(Standard) - A Simple and Powerful Electronic Circuit Design Tool = EasyEDA(Standard) - Un semplice e potente strumento di progettazione circuitale

#Dialog for Package Custom Data
Please input the data title = Inserisci il titolo dei dati
Data title duplicated =  Il titolo dei dati è duplicato
Cannot be more than {0} characters! = Non può contenere più di {0} caratteri!
Only latin alphabets, digits, underscore(_) and hyphen(-) are allowed. = Sono consentiti solo alfabeti latini, cifre, trattino basso (_) e trattino (-).
Invalid value of item {0} = Il valore dell'oggetto {0} non è valido
Update DFM = Aggiorna DFM
Custom DFM Data = Dati DFM personalizzati
Saved custom data successfully! = Dati personalizzati salvati con successo!
Save custom data failed! = Impossibile salvare i dati personalizzati!
Will replace the graphics and custom data of current document, after imported please adjust the 3D model. Continue or not? = Sostituirà la grafica e i dati personalizzati del documento attuale, dopo l'importazione bisogna regolare il modello 3D. Continuare o no?
Open footprint "Custom Data" dialog = Apri la finestra di dialogo "Dati personalizzati" del footprint

# Create lead shape
Create Lead Shape = 
Base on Pad Center =
Base on Canvas Origin =
Lead shape =
Footprint Type =
From pad shape =
Lead length =
Lead width =
Lead diameter =
Scaling ratio =
Leads creating direction =
Auto = Automatico
Horizontal = Orizzontale
Vertical = Verticale
Canvas origin to lead edge =
Canvas origin to body edge =
Lead soldering length =
Lead soldering part diameter =
Component shape object doesn't overlap lead shape object, please check carefully. =
The solder mask expansion of pads ({0},{1}) has a small clearance(less than 0.08mm), it will cause the soldering too short, please modify. =
The paste mask expansion or custom paste mask layer objects of pads ({0},{1}) has a small clearance(less than 0.15mm), it will cause the stencil to create fail, please modify. =
System footprint must have pad number 1 or A1, please modify the pad number. =
System footprint doesn't allow two or more pad numbers are 1 or A1, please modify the pad number. =
Document layer has circle object, but jlcPara's polarity is 0, please check the Custom Data. =
There are exist repeat pad numbers: {padNumber}, please check, if it is correct please ignore this. =
Can't find the circle at the component marking layer, or this circle doesn't at the same quadrant with the 1st pad, please check whether it is correct. =

ROUND = CERCHIO
RECTANGLE = RETTANGOLO
OCTAGONAL = OTTAGONO
Upper left = Superiore sinistro
Lower left = Inferiore sinistro
Center of Pads = Centro dei pad
First Pin = Primo pin
Package Name = Nome del contenitore
Pins Number = Numero di pin
Rows Of Pin = Righe di pin
Columns Of Pin = Colonne di pin
Polarity = Polarità
Pad Shape = Forma Pad
Body Diameter = Diametro corpo
Lead Span =
Lead Vertical Span =
Body Length = Lunghezza corpo
Body Height = Altezza corpo
Pin Diameter = Diametro del pin
Pin Length = Lunghezza del pin
Pin Height = Altezza del pin
Pin Solid Width = 
Pin Solid Height =
Pin Spacing = Spaziatura pin
Pin Horizontal Spacing = Spaziatura orizzontale pin
Pin Vertical Spacing = Spaziatura verticale pin
ThermalPad = Pad termico
Pad Expansion = Espansione pad
Custom PasteMask =
Fabrication Tolerance = Tolleranza di fabbricazione
Placement Tolerance = Tolleranza di posizionamento
FirstPin Position = Posizione del primo pin
Package Origin = Origine del contenitore
Expansion Size = Dimensione di espansione
Corner = Angolo
Angle = Angolo
Fillet = Arrotondamento
Chamfer = Smussa
Update Preview = Aggiorna anteprima
Number of pins (left and right) = Numero di pin (sinistra e destra)
Number of pins (up and down) = Numero di pin (sopra e sotto)
Reference Use Cases = Casi d'uso di riferimento
Package Type = Tipo di contenitore
Capacitance = Condensatore
Resistance = Resistenza
Bidirectional Diode = Diodo bidirezionale
Inductance = Induttore
Crystal Oscillator = Oscillatore a cristallo
Diode = Diodo
LED = LED
Fuse = Fusibile
Entity height = Altezza dell'entità
Lead Overhang =
Lead Thickness =
Unknown mistake = Errore sconosciuto
Has ThermalVias = Via termiche
Polar Capacitance = Condensatore polarizzato

Create Component Marking = Crea demarcazione componente
Create component marking successfully! = Demarcazione componente creata con successo!
No elements on component shape layer! = 
No elements on lead shape layer! =
No pad of number 1 or A1, please modify the pad number. = Nessun pad del numero 1 o A1, modificare il numero del pad.
Save failed! Component marking circle is at the axis. Do you want to recreate the component marking? = Impossibile salvare! Il cerchio di marcatura del componente è sull'asse. Vuoi ricreare la marcatura del componente?
If autoroute fail, you can export the autoroute file(DSN) to third-party autorouter tool(Such as: Konekt Electra, Eremex TopoR etc.), and export the session file(SES) after finished autoroute, and then import to PCB. = Se lo sbroglio automatico non andasse a buon fine, puoi esportare il file di autoroute (DSN) in uno strumento di terze parti (come: Konekt Electra, Eremex TopoR ecc.) ed esportare il file di sessione (SES) dopo aver terminato lo sbroglio, quindi importare su PCB.
Auto route failed! Found abnormal pad(s) data, please modify the pad width and height: = Impossibile effettuare lo sbroglio automatico! Sono stati rilevati dati anomali del pad, modifica la larghezza e l'altezza del pad:
Select Properties = Seleziona proprietà
Combine the same parts' prefixes in one row = Combina i prefissi degli stessi componenti in una riga
Please check at least one item! = Controlla almeno un elemento!
Pins = Pin

